notaword | No sentence found.
que | cómo iban a poder con más de lo que se habían enfrentado hasta el momento
hasta | cómo iban a poder con más de lo que se habían enfrentado hasta el momento
a | cómo iban a poder con más de lo que se habían enfrentado hasta el momento
de | cómo iban a poder con más de lo que se habían enfrentado hasta el momento
cómo | cómo iban a poder con más de lo que se habían enfrentado hasta el momento
con | cómo iban a poder con más de lo que se habían enfrentado hasta el momento
el | cómo iban a poder con más de lo que se habían enfrentado hasta el momento
ir | cómo iban a poder con más de lo que se habían enfrentado hasta el momento
poder | cómo iban a poder con más de lo que se habían enfrentado hasta el momento
enfrentar | cómo iban a poder con más de lo que se habían enfrentado hasta el momento
momento | cómo iban a poder con más de lo que se habían enfrentado hasta el momento
haber | cómo iban a poder con más de lo que se habían enfrentado hasta el momento
se | cómo iban a poder con más de lo que se habían enfrentado hasta el momento
la | cómo iban a poder con más de lo que se habían enfrentado hasta el momento
más | cómo iban a poder con más de lo que se habían enfrentado hasta el momento
no | No puede haber más.
ser | —No, no lo es.
decir | —Dile que se vaya.
y | —Y que lo diga.
le | —Se ha ido —le dijo a Ereko.
estar | —Y Tayschrenn no está.
por | Por el gran Fanderay
todo | Vais todos a los korelri.
hacer | había hecho todo lo que había podido
él | Cómo se habían hecho con ella
qué | Qué hay de ellos
ella | qué iba a poder hacer él
ese | Él no es de esos.
en | por qué en ese momento y con él
hombre | Cómo se atrevía ese hombre
un | No era más que un hombre.
mirar | El hombre los fue mirando a todos.
saber | No sabes lo que puedes hacer, hasta que lo haces.
ése | —No sé por qué sabía que ibas a decir eso.
pero | —Pero Anand no lo sabe.
tener | Pero era todo lo que tenían.
pasar | —¿Qué está pasando? Tengo que saberlo.
asir | Así que, cómo no, había sido ella la que había tenido que ir.
preguntar | Y me preguntó qué podría ser eso.
cabeza | —¿Qué le ha pasado en la cabeza? —le preguntó Havva.
levantar | Levantó la cabeza y miró a Shurll.
parar | —Se levantó para irse.
comer | Timmel se levantó como pudo.
noche | ¿De qué va? —le preguntó a Noche.
si | —¿Puede? Me pregunto si es así…
este | Tenemos que saberlo esta noche.
su | Su, esta es Devaleth.
hablar | Pero fue como si Olo no hubiera hablado.
yo | —Yo estaba hablando de ellos.
algo | Qué me ha pasado para poder hacer algo así
ya | —Ya hemos hablado de eso.
te | Pero te diré algo.
nadar | —Ya te lo he dicho, nada.
otro | Seres que tienen más poder que otros, nada más.
quedar | En unos momentos no quedaba nada.
arrojar | Arrojo se quedó mirando al hombre.
solo | —Solo sabía que iba a pasar algo, Arrojo.
dejar | Sabían que no podía dejar que se enfrentaran solos a él.
entrar | pero deja entrar a mis hombres
do | Los dos que habían entrado con él se levantaron.
ver | Vio a dos hombres que se enfrentaban a Despellejador.
guardia | Ya solo quedamos los guardias.
deber | Está pasando algo que deberías ver.
bueno | —Bueno, si así es como debe ser.
parecer | Pareció pararse, así, por las buenas.
vez | No vamos a ver nada parecido otra vez.
mago | El mago de Jacuruku lo miró a su vez.
mucho | Pero la Guardia tenía que saber que Laseen no tenía muchos magos.
aquí | Y muchos de estos de aquí son de la Guardia.
una | Pero aquí estamos una vez más.
bajar | Jemain había bajado la cabeza una vez más.
después | Después bajó la mirada.
esperar | Espera hasta que hayan entrado y después hazlo.
ahora | Y ahora aquí están, ahora ya no tenemos que esperar más.
tiempo | Voy a hacer ahora lo que debería haberse hecho hace algún tiempo.
llevar | Y ya llevaba un tiempo esperando.
suponer | —Llevo mucho tiempo fuera, por supuesto.
oír | Oí hablar mucho de ellos en Darujhistan, por supuesto.
sí | Los dos se miraron entre sí.
sobrar | —Mucho más que eso —dijo, sobre todo para sí.
nos | —Yo digo que nos vayamos.
nuestro | —Lo haremos, una vez que nos hayamos llevado lo que es nuestro.
llegar | Bueno, supongo que a todos nos llega.
quizá | Quizá haya llegado el momento.
señalar | Señaló a otro de los guardias que quedaban.
manar | Levantó una mano y señaló.
voz | Y si había oído voces
quién | Y no sé quién es ese mago, pero no es de los nuestros.
mujer | Quién era esa mujer
o | un hombre o una mujer de gran poder
dar | O ya se la había dado
querer | Sé lo que quieres y no te lo voy a dar.
allí | —Dice que deberías estar allí, si quieres que lo hagan.
todavía | como si él o ella todavía estuviera allí
acercar | El otro se acercó y bajó la voz todavía más.
gestar | Esta le hizo un gesto para que se acercara más.
les | Noche les hizo un gesto para que se acercaran.
mano | Lo dejaré en manos de aquí Shell.
volver | Después volvió a mirar a Manos.
sin | —Espera un momento —dijo el hombre en taliano sin volverse.
hacia | —Se volvió hacia sus guardias—.
seguir | Sigue sin haber nada que hablar.
ojo | Los ojos de los dos lo siguieron.
sargento | Arrojo se volvió hacia el sargento Banath.
abrir | En ese momento levantó los ojos y abrió las manos.
brazo | Ghelel abrió mucho los brazos otra vez.
caer | Después dejó caer el brazo—.
hombro | Después los dejó caer y bajó los hombros.
poner | —Le puso una mano en el hombro.
tirar | —Quiere decir que los han estado tirando —dijo la mujer.
lado | Esta se tiró a su lado—.
zarigüeya | Zarigüeya se lo quedó mirando y dejó caer los brazos a los lados.
salir | —Debería salir más, sargento.
llamar | Nos llamó, pero no quiso salir de allí.
mientras | Deberíamos llamarlo a él —dijo el mago mientras se levantaba.
caminar | —Ella siguió hablando mientras caminaban—.
siempre | Por qué tendrían que seguir caminando así, sin parar, para siempre
bien | A ese hombre siempre se le había dado bien hablar y no decir nada.
muy | —Muy bien, sargento, que entren.
también | —Yo ahora también estoy bien —dijo con los ojos puestos en el thel akai—.
viajero | Viajero también miraba a un lado.
ni | Ni parece que vayamos a llegar.
tú | Se llevó a Janelle, dirán… pero tú lo sabrás.
correr | Les dije que habías salido corriendo para cargártelo tú.
echar | Noche habría echado a correr si hubiera podido.
espada | Genist fue a echar mano de su espada.
gritar | En ese momento Rell estaba gritando algo y señalaba con una espada.
maldecir | —¡Corra, maldita sea! —gritó el hombre.
éste | —¡Espera! ¡Espera, maldito seas! ¡No puedes hacer esto! —Echó mano de su espada.
tierra | Esto ha maldecido mis tierras
nosotros | Nosotros solo estamos de paso por las tierras de Bael, después de todo.
cuando | —¿Y qué hacemos nosotros cuando lleguen aquí? —preguntó Kyle.
uno | —Es un mago —le gritó uno al oído cuando pasó—.
encontrar | —Uno de ellos te encontrarás.
mismo | Era como si se enfrentaran a sí mismos, y, de hecho, así era, suponía.
coger | —Lo mismo que vas a coger tú —dijo uno.
crear | —Creo que eso quizá pueda hacerlo.
capitán | —¿Alil? Muy bueno, capitán.
lanzar | Fue el capitán de Lanza hace mucho tiempo.
ahí | Pero no creo que ella vaya a quedarse por ahí a esperarlos.
acechar | Acecho cogió a Kyle por el brazo.
caro | Acecho se había echado allí con un brazo sobre la cara.
inclinar | Sin volver la cara, Denuth se inclinó.
pensar | Rillish se inclinaba a pensar lo mismo.
morir | Zarigüeya supuso que ella también estaría pensando en la mujer muerta.
alguno | Y no era que algunos no fueran a morir esa noche.
responder | —Eso mismo estaba pensando yo —respondió el capitán.
entonces | Acecho se volvió entonces hacia Ereko.
trémulo | —¿Quién entonces? —preguntó Trémula.
ante | Trémula se inclinó ante Despellejador.
cuanto | —Cuanto antes salgamos de aquí, mejor…
venir | a qué viene tanto grito
verdad | —¿Qué más da? Si de verdad nos quisieran encontrar, ya lo habrían hecho.
meter | Tenías que meterte, ¿verdad? Debería haberlo sabido.
sonrisa | —Y se metió las manos bajo los brazos con una gran sonrisa.
asentir | Zarigüeya asintió con una sonrisa.
desde | Vamos a bajar desde ahí.
alrededor | Molk miró a su alrededor y le hizo un gesto para que bajara la voz.
casar | —Entonces deberían haberse quedado en casa.
mundo | Todo el mundo preguntaba qué había pasado; Toc no les hizo caso.
piar | Todo el mundo, hasta Heuk, se puso de pie.
sedar | Arrojo dejó de caminar y Seda siguió.
señora | —Sí, señor —respondió Kyle sin pensar.
poco | —¿Yo, señor? ¡Nada, señor! Solo un poco de sed, nada más.
alguien | Si viene alguien, cogedlo.
oscuridad | Alguien allí de pie, en la oscuridad
exclamar | —Muerta, señor —exclamó alguien en la oscuridad.
del | —¿El Kestral? —exclamó Trémula a los del otro lado.
tras | —Yo tengo esto… —exclamó tras Lim.
embozar | —Oye, mira, maldito del Embozado…
puerta | Seda señaló las puertas de enfrente.
reír | Hay dos puertas del Río entre nosotros y ellos.
humar | Humo se echó a reír.
apartar | —No lo encontrarán —dijo Humo en un aparte.
vieja | —Habla, viejo —dijo sin apartar los ojos.
yelmo | Arrojo vio que todavía llevaba el maldito metido bajo el brazo como si fuera un yelmo.
contra | Lurin se lanzó contra Shurll.
luchar | No pueden luchar contra él y contra nosotros al mismo tiempo.
bordar | Algunos lucharon, otros se tiraron por la borda.
joven | Toc se acercó y esperó, pero los jóvenes no le hicieron caso.
alzar | Los ojos se alzaron y se encontraron con los del joven.
ventar | Se alzó un viento alrededor de los dos.
aquel | Hicimos lo que pensábamos que debíamos hacer en aquel momento.
boca | Abrió la boca, pero no salió nada.
acorde | Poco antes, Rillish se había inclinado hacia el sargento Acorde para hacerle una pregunta.
nadie | —No se deja pasar a nadie, Acorde.
mover | Nadie habló ni se movió.
cortar | Le cortaste la cabeza mientras no podía moverse.
encoger | Jemain se encogió de hombros para asentir.
modo | Pero este no era el modo en que nadie quería que pasara.
largar | De otro modo habríamos tirado de largo.
silenciar | Tras el largo silencio que siguió, levantó los ojos—.
juntar | Acecho, junto a Kyle, asintió en silencio.
jamás | Jamás antes había oído hablar a aquel hombre de ese modo.
menos | Yo, por lo menos, espero no volver a verlos jamás.
suelo | —¡Aquí está! —Alguien se arrojó al suelo junto a ella: Shell—.
primero | Me pregunto quién de ellos será el primero en cortarte la cabeza.
día | Y sí que te querían encontrar esos primeros días.
cosa | Tengo que ponerme al día en muchas cosas allí.
pedir | Y sí, las cosas salieron a pedir de boca.
mí | Has venido a pedirme algo a mí
seguro | —No saben que me tenéis a mí —dijo, o pareció decir, Ullen no estaba seguro—.
subir | Ahora, déjeme subir a bordo.
dentar | —Ammanas… —dijo Viajero entre dientes.
juramentar | —Algunos —dijo entre dientes— lo llaman el juramento de Liss.
dolor | Dolor se encogió de hombros.
dirigir | —Dolor levantó la voz y se dirigió a todo el mundo—.
cercar | Siempre más cerca de lo que tú te crees, Mallick Rel.
abierto | La mujer se dirigió a la puerta abierta.
tipar | Olo se quedó mirando al tipo con la boca abierta.
puñar | El amiguito del tipo no era el puño.
risueño | Risueño alzó un puño.
detener | Arrojo cogió a Risueño del brazo para detenerlo.
comandante | Una comandante de la mano se detuvo a su lado.
tan | ¿Meterse? Ya no es tan joven, comandante.
mi | Ameron era mi comandante.
partir | —Yo seguiré mi camino a partir de ahí.
formar | El otro se está formando a partir de las espadas que se enfrentan a nosotros.
observar | Observó a un sargento que les gritaba a sus hombres para que formaran.
nombrar | Se acercó a Arrojo y dijo—: Pueden maldecir mi nombre, Arrojo, siempre que mueran haciéndolo.
atrás | Ullen observó que el hombre echaba el puño hacia atrás una vez más.
batallar | —Por aquel entonces también formábamos para la batalla, Imotan.
desaparecer | Dio un paso atrás y desapareció en la oscuridad.
eh | —Eh, ese tipo, Harmin, creo que a partir de ahora deberíamos llamarle Sonrisas.
forzar | Caerá sobre las fuerzas talianas.
campar | En campo abierto otra vez, como tanto tiempo atrás.
carcajada | Bajó al campo de batalla, entre los caídos, riéndose a carcajadas.
labio | Una sonrisa le tiraba de los labios y lanzó una risita, después una carcajada abierta.
ningún | —¡Esperad, maldita sea! —Ninguno se detuvo.
rata | Los dos se miraron un rato sin que ninguno apartara los ojos.
durante | Siguieron caminando en silencio durante un rato.
marcar | Ni el marqués ni Ghelel hablaron durante un rato.
empezar | —No le haga caso… —empezó a decir el marqués.
k | K’azz muerto o desaparecido.
juramentado | K’azz, Trémula y los otros juramentados, todos se inclinaron ante aquel hombre.
piedra | Diles que suban más piedras.
golpear | Arrojo se golpeó la cabeza contra el suelo de piedra.
intentar | El hombre intentó golpear el brazo de Viajero.
sacudir | Intentó sacudir la cabeza, ¡cómo le daba vueltas! No paraba.
soldar | Está seguro de que no hay ningún soldado ahí fuera
último | No hasta que caiga el último soldado.
demasiado | Me he dejado llevar por ella demasiado en los últimos tiempos.
casi | No sabemos casi nada de ella, a decir verdad.
muchacha | Pero ahora estamos muy cerca, muchacho.
espalda | Noche les dio la espalda a los guardias y les levantó el puño a sus muchachos.
aguar | Viajero le dio la espalda y Ereko subió tras él y salieron del agua.
abajar | Después de todo, hay muy poca agua por aquí abajo.
arribar | Ogilvy le lanzó una larga mirada, de arriba abajo.
sur | ¿Quién iría río arriba por aquel entonces? ¿Pieraro? No, él va al sur.
jinete | —Jinetes que se acercan desde el sur —dijo en un aparte.
reunir | Ameron se reunió con ella cuando se dirigió a encontrarse con los jinetes.
soldado | Reúna a los soldados de la corte.
orden | —Nuestras órdenes… —empezó a decir uno.
buscar | Antes de que todo el mundo se dirija a ellos en busca de órdenes.
oscuro | La forma oscura pasó nadando a su lado.
alto | —Todo campo abierto —dijo Noche, que estaba pensando en voz alta.
mandar | —¡Que me manden al mago! —gritó Trémula tan alto como pudo.
regresar | Le pido que regrese a su mando, al sur del Idryn.
dios | ¡Dioses! Las cosas que tenían que hacer para poder regresar a Stratem.
ayudar | —¡Dioses, mujer! Bueno, al menos ayúdame a levantarme.
pues | —¿Quieres ayuda? Pues ahí la tienes.
ninguno | —Bueno, pues entonces no dé ninguna orden.
jorobar | Se encontró con que había esperado demasiado, Joroba no estaba por ninguna parte.
sentar | Siento que tenga que ser de este modo…
parpadear | Se puso en pie parpadeando y sacudiendo la cabeza.
agachar | Unas manos tiraron de él y se agachó con un parpadeo.
mueca | Acorde hizo una mueca y se agachó.
hojalatero | —¿Eh? ¿Quién es? —El hombre vio a Hojalatero y volvió a hacer otra mueca—.
cada | Hojalatero estaba mirando al juramentado, que cada vez se acercaba más.
ere | —Liss… siento abrirte los ojos, pero ya no eres ninguna jovencita.
oficial | No sé los nombres de los oficiales y magos de Kan y Cawn que están aquí.
rodear | Los hombres y las mujeres que rodeaban a Noche gritaron y señalaron a un lado.
contar | —Solo si cuentas los soldados que nos rodean.
garra | Por fuerza estarás al mando de la Garra.
mayor | Como irá Zarigüeya y la mayor parte de la Garra.
limitar | El sargento mayor Temp se limitó a observar a Noche durante un rato sin decir nada.
perder | Se había limitado a perder la cuenta
conseguir | ¿Cómo lo conseguiste? Todo el mundo cree que se perdió.
necesitar | —Supongo que creen que van a necesitar toda la ayuda que puedan conseguir.
continuar | —Necesita todos los brazos que pueda conseguir, comandante —continuó Udep.
ti | Te queremos a ti, nos vendrías muy bien, pero necesitamos saberlo.
marchar | ¡Di la orden de marchar! La Guardia continúa en el campo de batalla.
cogulla | Pero uno no se limita a «echar un ojo» a hombres como Cogulla.
gris | El viejo Gris va a armársela a Cogulla.
melena | —¡Acecho! —Kyle buscó entre los hombres y lo encontró cerca de Melena Gris.
golpe | Tú o… —se detuvo y después continuó de golpe—, Melena Gris.
ciudad | —Quiere decir —continuó Seda— que esta noche han dado un golpe de estado en la ciudad.
sacar | Yo he metido a mis hombres en esto y yo los voy a sacar
aire | Gujran sacó su espada corta y la alzó en el aire.
repente | —¡Primera espada! —exclamó Laseen de repente, casi cortando el aire entre los dos—.
delante | Molk, que corría por delante de ella, desapareció de repente.
siquiera | El oficial de Cawn ni siquiera se habría dado cuenta de a quién tenía delante.
e | El capitán asintió e hizo una mueca.
encimar | —Dioses, estarán hablando hasta que la última noche nos caiga encima.
saludar | —O te estaba saludando a ti.
veterano | La veterana se detuvo delante del hombre, que inclinó la cabeza a modo de saludo.
conocer | —Se reunió con un viejo veterano seti que conocía de antes.
grande | —Entonces vamos a conocer a esos grandes poderes.
visto | El más grande que he visto jamás.
creer | He luchado contra muchas cosas y he visto cosas que sigo sin creerme.
incluso | Incluso creyó oír que lo llamaban por su nombre una o dos veces.
lejos | Él solo había visto a esos dos comandantes de lejos y esperaba que así siguiera siendo.
terminar | —Será mejor que no termine siendo la espada —dijo una voz no muy lejos.
gruñir | Dol se lo quedó mirando y la carcajada terminó con un gruñido de dolor.
girar | Al girar exclamó algo, el joven respondió con un gruñido y se puso en guardia.
sentir | Parpadeó y sacudió la cabeza, pero se sintió como si todavía estuviera girando.
aunque | Viajero se giró hacia ellos, aunque sus ojos se detuvieron en la entrada un poco más.
acabar | Bueno, pues tendremos que acabar con eso aunque sea a golpes.
pequeño | Un gesto muy pequeño… pero sentía que le debía a la joven al menos eso.
anciano | —Estoy buscando a unos ancianos, pequeña.
sonreír | La anciana se limitó a sonreírle a Risueño.
blanco | —Volvió a sonreír con sus dientes blancos—.
posible | —Acabo de decir que mandó llamar a todos los posibles, incluso en Malaz.
línea | Tras las líneas esperaban las espadas de la Guardia, veteranos y juramentados todos y cada uno.
tensar | La mujer se limitó a sonreír, las líneas que rodeaban su boca estaban tensas.
alentar | —Vuelve a mí —dijo ella, la voz tan tensa que casi parecía haberse quedado sin aliento.
igual | —Jinetes —dijo Acorde en un aparte, aunque Rillish podía oírlos igual de bien.
nuevo | —Igual que en los viejos tiempos, ¿eh? Y hablando de eso, veamos esa nueva espada.
senda | Pero soy nuevo en estas sendas.
dónde | De dónde habían salido, por todas las sendas del Embozado
barco | —Todos sus barcos nuevos son viejos.
negro | Maga de barco, salida de Ciudad Negra.
adelantar | De ahora en adelante no dejamos de movernos.
tardar | Melena Gris tardó un rato en responder, pero Kyle lo sentía allí, más cerca.
sangrar | Si la sangre joven seti no estaba ahí fuera ya, no tardaría en estarlo.
atención | El yelmo se giró y lo observó con más atención.
único | —¡Trémula! No eres la única con la que habló Humo.
regalar | El regalo que le había hecho Osserc; ni siquiera la había sacado todavía.
suspirar | Dolor suspiró y miró a Regalo, que se encogió de hombros.
montura | —¿Y tú crees que quiero? —Talia suspiró, acercó la montura y le cogió el brazo—.
militar | El sargento Acorde hizo un saludo militar, giró su montura y se adelantó.
secar | Otro saludo seco, un giro militar y salida.
apoyar | El jinete se detuvo en seco, con la lanza apoyada.
luz | El haz de luz regresó.
mal | —Como te dije, soldado —dijo su sargento—, te va sentar mal.
cierto | —¿Es eso cierto, señor? Un mal día, aquel.
propio | Pero la había, ¿no es cierto? El propio Ryllandaras.
agitar | Ehrlann la cogió y la agitó delante de su propia cara.
pelar | Nada se apartó de la cara el pelo agitado por el viento.
dedo | Seda se pasó los dedos por el pelo y suspiró.
esbozar | Miró a Risueño, que levantó un dedo e intentó sonreír; solo pudo esbozar una mueca.
baja | —¿Dónde estamos? —le preguntó Regalo a Dedos, en voz muy baja.
tal | Tal y como han quedado, puede que todavía quieran sangre.
esforzar | Lo único que se espera de ti es que te esfuerces por hacerlo.
murmurar | Al menos unos cuantos de sus oficiales hicieron el esfuerzo de murmurar «Sí, señor».
proteger | —Que la gran diosa nos proteja —murmuró Liss, la cabeza girada de repente hacia el este.
coser | No hacemos tal cosa.
matar | —Hay una cosa —murmuró—, pero solo conseguirás que te maten.
tropa | —Joroba… ¿Estás aquí? Las tropas de Trémula ya han partido.
imperial | —Nos enfrentaremos a los imperiales, pero ninguno de mi tropa.
antiguar | Una vez más nos enfrentaremos a los imperiales, quizá a los de tu antigua tropa.
arma | Te lo pido de nuevo, tirad las armas.
saltar | Los juramentados maldijeron, se levantaron de un salto y echaron a correr mientras sacaban las armas.
chico | Se levantó de un salto, ya había sacado otras armas, pero la chica había desaparecido.
fruncir | Mallick frunció los labios, pensó en sentarse enfrente de la chica, pero después se arrepintió.
ceño | Frunció los labios, apartó la mirada y después se le marcó el ceño.
estudiar | La anciana lo estudió con atención una vez más, con el ceño fruncido.
hoja | El mago frunció el ceño mientras estudiaba la hoja.
tender | El camino de la chica la llevó de regreso a las tiendas de los oficiales.
entender | Se preguntó a qué estaban esperando, pero entonces Viajero entró en la tienda y lo entendió.
vuestro | No entiendo vuestras sendas.
hermane | —No somos hermanos vuestros.
frente | El mayor de los hermanos Perdidos se llevó una mano a la frente y suspiró.
puntar | Había estado a punto de hacerle saltar y salir corriendo
contener | Zarigüeya estuvo a punto de inclinarse, pero se contuvo a tiempo.
mantener | Tenemos que mantener contenidas a las fuerzas kanesianas.
alejar | Pero sabía que no podrías mantenerte alejado.
ademán | Entonces llegaron otros guardias y alejaron a Kyle con unos cuantos ademanes.
erguir | K’azz se irguió y habló en voz alta.
mala | —¡Lo va a matar! —exclamó Malas Tierras.
fuego | Malas Tierras se agachó junto al fuego.
podar | Espero que podamos verlo más tarde.
usar | Quizá podamos usar la senda Imperial para movernos…
caballo | Caballos y hombres acabaron por los aires, dando vueltas.
quitar | Detuvieron los caballos; la espada se quitó el yelmo e inclinó la cabeza.
puñetero | No me puedo creer que esté protegiendo unos malditos caballos, por el puñetero Embozado.
fuerte | El puñetero viento es demasiado fuerte.
pena | Penas sacó dos hojas cortas.
idiota | —¡Yath! ¡Serás idiota! —gruñó Penas.
cruzar | No creerías de verdad que seríamos tan idiotas como para cruzar las espadas con él, verdad
emperador | Dices que apoyas a la emperatriz.
cerrar | La puerta se cerró y la emperatriz y él se quedaron solos.
chillar | —¡Cerraos! —chilló la mujer mientras se levantaba.
disparar | —¿Quién ha disparado? ¡He dicho que no abran fuego! —chilló a grandes voces.
palabra | —No tenía… —Viajero contuvo las palabras y se llevó un puño a los labios.
tomar | No creas que no te voy a tomar la palabra.
claro | Claro que no se supone que tengamos que conseguirlo.
musgo | Musgo solo pudo sacudir la cabeza, para él estaba muy claro, maldita fuera.
servir | Tendrá que servir —suspiró Musgo, y con un gesto mandó continuar a sus hombres.
os | —Así que os servisteis solos.
gracia | Y os damos las gracias…
focha | —¿Qué es eso? ¿Jhogen? —Fochas cayó entonces en la cuenta y esbozó una sonrisa sin gracia—.
cuchillo | Fochas y Malas Tierras dieron un salto y sacaron unos cuchillos.
susurrar | —Coge el cuchillo —le susurró—.
barra | —¿Dónde crees que estamos? —susurró Barras.
final | Barras asintió con un gruñido, algo le había dicho que al final terminarían así.
escuchar | Escucha, no te lo tomes a mal.
enviar | Te quedarás y escucharás todo lo que este enviado tiene que decir.
porque | Lo siento más porque yo no habría enviado a alguien como tú.
gustar | Porque si es así, aquí a mi sargento le gustaría mucho dispararte.
decidir | Ghelel decidió que quizá terminara gustándole eso de ser oficial.
suficiente | Zarigüeya decidió que quizá ya había observado durante tiempo suficiente.
escupir | —Hemos terminado —escupió y se giró para alejarse con paso decidido.
ladear | —Acorde ladeó la cabeza para asentir y escupió en el suelo.
pesado | Había ladeado la cabeza de frente pesada como si estuviera escuchando.
huir | Ponía los ojos en blanco, buscaba una forma de huir, le pareció a Arrojo.
costar | Trémula se irguió y se acercó al costado del barco.
pasa | —¿Qué pasa ahí abajo? —chilló tan alto como pudo.
lugar | qué nos pasa cuando volvemos a esos lugares, eh
vida | Verdades antiguas continúan con vida en algún lugar.
salvar | El único lugar en el que debió de creerse a salvo de todo el mundo.
amigar | No pensé que nadie, salvo aquí mi amigo, pudiera moverlo.
favor | Por favor, piensa en todas las vidas que se van a perder.
donde | El otro levantó un dedo y señaló el lugar donde había caído el talwar—.
recordar | Había un hombre donde Lurin no recordaba haber visto a nadie caminar jamás.
avanzar | Igual que deben saberlo ellos, al parecer, de otro modo no estarían avanzando.
aparecer | Cogulla apareció entonces a su espalda, fue como si saliera de la nada.
año | —Cada año se supone que van a aparecer.
muralla | Por aquel entonces los soldados malazanos llevaban ya unos años apareciendo en la muralla.
norte | Échale un ojo a la muralla norte.
llenar | Por esta noche ya está lleno, se dirige al norte.
supremo | El puño supremo se quitó el yelmo.
fin | Trémula por fin se enfrentó al antiguo puño supremo.
maldición | Diste tu vida para poner fin a la maldición.
imperio | Hemos venido para llevaros a todos de regreso a Quon para luchar contra el Imperio.
tono | Baja un poco el tono.
bastante | veteranos que parecían bastante mayores
idear | Bueno, ella tenía una idea bastante clara de quién podía ser.
señor | Que la Señora los salve, ha empezado.
cubierta | —Sí, señora —respondió alguien desde la cubierta.
vaciar | —¡Capitán! —le gritó Hojalatero a lo que parecía una cubierta vacía.
nunca | —Uno que se ha movido por el vacío lo suficiente para saber que esto nunca terminará.
cambiar | algunas cosas nunca cambiaban
cuerpo | El cambio del suelo seco llevó su atención al más antiguo de los dos cuerpos.
freír | Había hecho un frío puñetero todos esos años en Korel.
carmesí | Cuando pasaron por allí, los guardias carmesíes se hicieron con todas esas armas.
tres | Los guardias fueron abriéndoles paso a los tres.
vosotros | —Vosotros tres —les dijo a los otros— podéis iros.
chica | Tres de nuestros chicos más fuertes tirarán de él.
mío | —Vosotros haced el vuestro, que yo haré el mío.
informar | Pero el único informe que Anand escuchará es el mío.
limpiar | —Levantó la mano y cogió un puñado de informes para limpiarse la sangre—.
intercambiar | Tras la montura del comandante, Ullen y Musgo intercambiaron una mirada, pero no dijeron nada.
armadura | —Ghelel empezó a cambiarse para ponerse la armadura.
permanecer | Ho permanecía en silencio, con los ojos puestos en el hombre muerto.
vista | Los dos magos que permanecían a la vista de Noche levantaron los brazos.
razón | —Mucha más razón desde el punto de vista de él, supongo.
seriar | —¿En serio? No creía que fuera posible.
imaginar | ¿Con quién más podía contar? Con la mayor parte de sus tropas, se imaginaba… y esperaba.
pelotón | Lo lanzó a él y a su pelotón hacia atrás, aunque estaban echados bocabajo.
retirar | Se volvió hacia su pelotón, que permanecía allí observando a los jinetes que se retiraban.
permitir | Nos permitirás retirarnos sin más
yegua | —Bueno, gracias, capitán Musgo, por permitirme usar su caballo.
pesar | —¿Y qué haríamos con él? Pesa demasiado para subirlo a un caballo.
vuelta | A pesar de sí mismo, se dio la vuelta.
d | ¡Había tenido que abrir esa puñetera bocaza de D’rek! Ya no había vuelta atrás.
estirar | Unas manos se estiraban como garras…
ballesta | —Entra aquí —le gruñó y estiró el brazo para cogerle la ballesta.
callar | En la puerta, un guardia observaba la calle con la ballesta levantada.
furioso | Yath se calló, con la mirada furiosa y sin dejar de mover la boca.
indicar | —A Manos, que lo miraba furiosa, el sargento le indicó con un ademán que siguiera.
entrecerrar | Con los ojos entrecerrados, Lurgman se volvió para observar furioso el agua.
apretar | El sargento Acorde apretó los labios y apartó la vista con los ojos entrecerrados.
durar | La boca del hombre se apretó en una línea dura.
sombra | Entrecerró los ojos y miró en la oscuridad de las sombras de la tarde que caía.
envolver | El mago permanecía en pie sobre la nada, erguido, envuelto en sombras que cambiaban.
presenciar | La presencia fue hacia el muchacho y pareció envolverlo.
suyo | —Sí… Mató a uno de los suyos delante de mis propios ojos.
oh | —Oh, sí, por favor, infórmenme.
cualquiera | —Oh, cualquiera lo bastante fuerte, me imagino.
vivo | Podía mirarlos, podía mirar a cualquiera, vivo o muerto, y no verlo.
ocupar | —Nos ocuparemos de eso entonces, suponiendo que alguno siga vivo.
examinar | Dolor la examinó de arriba abajo.
cercano | Noche examinó los cierres de la más cercana.
profundar | —Nuestros hermanos nos necesitan —decía con voz profunda el moranthiano—.
defender | —Lucharé para defenderme —dijo con voz baja y profunda.
puerto | —No tienen suficientes hombres para defender el puerto.
mediar | Entonces ponte en medio y defiéndete, que el Embozado te lleve
sisear | —¡Quitaos de en medio, idiotas! —siseaba.
sentido | —Chille otra vez y la dejo sin sentido —siseó en voz muy baja—.
justar | No tenía sentido quedarse justo donde cualquiera que mirara querría que estuvieras.
ustedes | —Justo donde se encuentra usted.
húmedo | Kyle se secó la cara húmeda y fría y parpadeó.
barbilla | Molk levantó la barbilla para indicar algo a espaldas de la chica.
orillar | El marqués levantó la barbilla para indicar la otra orilla.
expresión | Storo estaba mirando la orilla oscura con expresión tensa.
cuello | Cogulla se llevó una mano al cuello y se esforzó por mantener la expresión seria.
molestar | —¡Para morir! —gruñó Barras con expresión furiosa, pero no tendría que haberse molestado.
comentar | Permite que te diga que tengo unas cuantas cosas que comentar con ella, si quisiera molestarme.
embargar | Sin embargo, primero tendría que comentar todo lo que acababa de oír con Seda.
prisa | Se la metió a toda prisa en la saquita que llevaba alrededor del cuello.
untar | —Cuando regrese, infórmele de que partiremos de Unta a toda prisa.
contestar | Molk, con la cabeza ladeada para escuchar la noche, le contestó con un susurro.
alcanzar | —No creas que estás fuera del alcance de la emperatriz —dijo entre dientes.
falta | Da igual, cuando alcancemos el puerto, esos cawneses se acercarán sin falta.
acordar | Debemos llegar allí antes de que se alcance algún tipo de acuerdo.
librar | —Se llegó a un acuerdo y sois libres de iros —dijo Viajero.
ganar | —Podrían ganar mucho llegando a tiempo para librarla…
oportunidad | ¡Oponn nos libre! Quizá al final hasta tuvieran una oportunidad.
ola | —Estamos perdidos, señor —exclamó él por encima de las olas.
filar | Tras ellos, los soldados seguían marchando, desapareciendo bajo las olas fila tras fila.
aplastar | —La Guardia Carmesí quiere ver aplastado el Imperio.
herbar | El viento aplastó las hierbas pesadas.
guerra | Son ellos los que ganan las guerras.
desear | Todo lo que un hombre de guerra deseaba, si ganaban.
estremecer | Pero tal y como estaba, a Noche ya le sirvió para estremecerse.
sorprender | El anciano se estremeció, sorprendido otra vez.
ceja | La mujer alzó las cejas, sorprendida.
ocultar | Anand frunció el ceño, las cejas blancas se acercaron tanto que casi ocultaron los ojos.
cuidar | Otra presencia, oculta con más cuidado incluso, esperaba.
oeste | Cruce, diríjase al oeste.
rápido | El agua clara corría hacia el oeste a su alrededor, poco profunda pero rápida.
nervioso | Taya y él intercambiaron una mirada rápida y nerviosa.
mirada | Nervioso, Arrojo y Risueño le lanzaron a su comandante miradas sorprendidas.
hora | —Cámbiese, rápido, salimos a caballo en menos de una hora.
sugerir | —Hora de huir —sugirió Fochas.
mesar | Algo más tarde, esa misma noche, Arrojo le sugirió algo a la mesa.
arrastrar | Nevall inclinó la barbilla a modo de saludo y arrastró los pies hasta su mesa.
apenar | Ahora, sin embargo, apenas puedo reunir las fuerzas para seguir adelante.
distanciar | Tres más se encontraban en pie a cierta distancia, los ojos muy abiertos.
cubrir | dónde se podía encontrar una batalla a la distancia que pudiera cubrir un caballo
cielo | Devaleth alzó los ojos al cielo cubierto y murmuró maldiciones para sí en korelano.
figurar | La figura se detuvo ante él, a una distancia segura.
colina | Se habían reunido allí todos los soldados solo para cubrir la colina de muertos
detrás | —Pues yo diría que es esa grande de la colina —sugirió Molk detrás de ella.
sujetar | Pero Sessin ya estaba allí, saltando por detrás de Yath para sujetar al juramentado.
pierna | Se sujetó la pierna.
hundir | Se dio un golpe en la cabeza y el cuerpo y las piernas se hundieron.
reconocer | Noche miró, lo reconoció, se levantó con una mueca y se apoyó en una pierna.
obviar | Quizá pensaba que era demasiado obvio para comentarlo.
polvo | —¡De mujer, por supuesto! ¿Es que no es obvio? —Y se alejó arrastrándose y levantando polvo.
recuperar | Jorrude recuperó su yelmo y le quitó el polvo.
surgir | Surgían entre la hierba, disparaban y volvían a agacharse.
atacar | Solo el dalhonesio los siguió para continuar sacando partido del ataque.
poblar | Más que hablar con los nabrajanos, su pueblo lo que hacía era atacarlos.
mercenario | He oído que el ataque de unos mercenarios le costó muy caro.
inmóvil | El mercenario salió y arrastró una forma inmóvil hasta la orilla.
ruido | —Shhh —dijo sin ruido y esperó, inmóvil en las sombras.
padre | ¡Vaya! ¡Era él! El padre Cielo de su pueblo.
trabajar | Mientras trabajaba, Arrojo pensó otra vez en su padre.
saboteador | —En pie toda la noche con los saboteadores, ayudándolos a ocultar su trabajo.
cuánto | Noche se preguntó cuánto tiempo duraría eso.
dentrar | No hay forma de saber quién está dentro ni cuántos.
mar | Uno no se hunde en este mar.
respuesta | Como única respuesta, la maga del mar señaló lo que tenían delante.
retroceder | —Viajero retrocedió con cuidado y con los ojos entrecerrados.
visión | Los magos habían avanzado y aparecido en su campo de visión.
muerte | —Te estás muriendo —dijo la visión de la muerte—.
siete | Una mujer gritó para preguntar si acababan de regresar de Siete Ciudades.
cuadrillo | Conté siete cuadrillos de ballesta en su cuerpo.
escudar | Sisearon los cuadrillos, golpearon el escudo y tiraron de ella, pero no se detuvo.
débil | Se apoyó en su escudo, de repente tenía las piernas débiles.
rodilla | De repente sentía las rodillas muy débiles.
chamán | Al acercarse, reconoció al chamán, Aguaclara, hundido hasta las rodillas.
señal | El chamán asintió y le hizo señal a un guardia, que se alejó a caballo.
cuatro | Quedan cuatro de mí que siguen vivos.
trapo | La figura agitó una mano envuelta en trapos.
rezongar | —No me gusta esto —rezongó Nervioso.
desgarrar | Parecía que el mago supremo intentaba meterlo a la fuerza por su propio desgarro.
escaramuzador | Por qué no lanzar los escaramuzadores y hacer la señal de avanzar
romper | —¡Vamos a romper el frente de escaramuzadores aquí o morir! —Señaló a los jóvenes—.
fila | ¡Rompan filas! Salvo por los sargentos de saboteadores.
movimiento | Un movimiento por detrás, entre las filas, y una mano golpeó el hombro de Noche.
copar | Ghelel se sentó con movimientos pesados y se sirvió otra copa de vino.
tragar | Ullen se tomó de un trago la copa antes de contestar.
guerrero | Con un movimiento de las rodillas, el guerrero hizo retroceder a su montura.
tanto | Dónde había reunido Imotan a tantos guerreros
salvaje | Hubiera dicho que usted estaría de acuerdo con ese tal Salvaje.
bramar | —¡Alto el fuego! ¡Alto el fuego! —oyó Noche que los sargentos bramaban entre los escaramuzadores.
dormir | En las últimas noches apenas había dormido.
amanecer | Y ahora —dijo—, sugiero que intentemos dormir un poco antes del amanecer.
pálido | El amanecer llegó como oscuridad, tan pálido y débil era.
lento | —Cuanto más grandes son, más lentos —dijo Acecho mientras les metía prisa.
extrañar | —A muchos de los juramentados les extraña que estés aquí con nosotros, Melena Gris.
lucir | Kyle también echaba miradas rápidas, pero no veía nada más que luces extrañas en el cielo.
incapaz | Por alguna razón era incapaz de tirarlo.
aguardar | Ni siquiera la muerte os aguarda ya.
teniente | —El teniente se sacudió, maldijo a los idiotas que aguardaban bajo sus pies.
columna | —Ya hace rato que pasó la columna, teniente.
espaciar | Un hombre con armadura ocupaba el espacio entre dos columnas.
tocar | Ho estiró la mano poco a poco para tocar la punta.
unir | Estaba a punto de unirse a la fila cuando Acecho le tocó el brazo.
garganta | Después metió los dedos bajo la barbilla del guardia para aplastarle la garganta.
sombrar | Tú podrías llamarlo la senda de Sombra, o Meanas, o como quieras.
redondo | ¡Sombra! Giró en redondo y encontró lo que buscaba: el mago, a cierta distancia.
cabello | Cabello largo y negro.
revelar | Su luz carmesí revelaba lo que aguardaba más adelante… nada.
diosa | Un lugar donde el dios del mar envía a aquellos que maldice.
asesinar | Habéis asesinado a un dios de mi pueblo
compañía | Tarkhan, capitán y asesino de la compañía.
ejército | Storo Matash, capitán de una compañía de saboteadores, veterano del Tercer Ejército
explicar | Ahora tengo que explicarles a los míos por qué y cómo acabamos de cambiar de ejército.
tampoco | Nunca explicó tampoco por qué no murió defendiendo a su dios-ciudad.
niña | Ni una señal de ningún niño, ni de lucha tampoco.
dulce | Dulce Muchacho rezongó algo y señaló la boca del puerto.
respirar | Y entonces, ¡gracias a Soliel!, respiró, aire limpio y dulce.
crispar | Zarigüeya cerró la boca de golpe y crispó las manos para que se llenaran.
rostro | El rostro se le crispó de dolor.
distinguir | Genist oyó las respuestas que exclamaban, pero no distinguió las palabras.
inquietar | Parecía inquieto mientras sacaba y examinaba la hoja de su cuchillo—.
posar | La mirada que posaba en la anciana parecía inquieta, cosa poco propia de ella.
ah | —¡Ah, eso! No tengo ni idea.
doblar | Una espalda tan tensa que Zarigüeya imaginó que era incapaz de doblarse.
cuero | Le metieron un cuero doblado en la boca a la fuerza.
frotar | Acecho apretó una saquita de cuero que llevaba al cuello y después la frotó.
sitiar | Puede que sea tu última oportunidad de salir de este sitio antes de que te mueras.
arrodillar | Humo se arrodilló e hizo algo con las manos sobre el suelo de piedra.
yacer | Regalo estaba allí, arrodillado al lado de su amigo, que yacía inmóvil.
terreno | Kyle estudió los terrenos, estaba claro que nadie subía allí jamás.
asombrado | Asombrado, Rillish dejó que su caballo perdiera terreno y regresara a la fila.
simple | Con cuidado, asombrada por el simple hecho de continuar con vida, Trémula se levantó.
perdido | Kyle se adelantó un poco y recuperó el terreno perdido.
absoluto | Pero ¿un niño? En absoluto.
hacendar | Pero tengo que saber lo que estáis haciendo vosotros dos.
grito | —¿Qué estáis haciendo aquí? —contestó a gritos con una mueca de dolor.
resonar | De repente resonaron unos gritos en la oscuridad.
interior | Una maldición resonó en el interior del yelmo.
bosque | Malas Tierras y Fochas asintieron y echaron a correr hacia el interior del bosque.
preocupar | Jhest, sin embargo, no parecía en absoluto preocupado.
ordenar | —Debes ordenar a tus hombres que dejen caer las armas.
caballería | Cuando lo encontró le ordenó que regresara con la columna de caballería.
caudillo | —Asesinadlo y marchad —ordenó el caudillo.
guiñar | —Joroba sonrió y guiñó un ojo—.
sostener | Él le sostuvo la cabeza y después sacó la mano húmeda de sangre.
persona | La maga mare era la única persona que se sostenía sin ayuda sobre la cubierta.
resultar | La simple verdad era que resultaba demasiado grande para esas personas pequeñas.
especiar | Resultó que era una especie de veterano malazano que había servido con el sargento mayor.
luego | Kyle deseaba seguirlos, desde luego sabía que no debería quedarse.
madera | Trabaja la madera allí.
enemigo | El enemigo, Yath, estaba cerca del borde abierto y agitado del desgarro.
ladero | Una voz bramó y resonó por toda la ladera.
separar | Él cruzó el espacio que lo separaba de ella.
junto | Hombres y mujeres gritaban, corrían juntos, se separaban.
puesto | El viejo Orhan y yo podemos intercambiarnos el puesto.
hermandad | —La hermandad informa que es el mago supremo —dijo Trémula con tono asombrado.
mensajero | —La hermandad dice que ha llegado un mensajero en busca del comandante Urko.
enterar | El mensajero levantó la voz y se dirigió al fuerte entero.
exterior | —Que la compañía entera baje aquí, Dulce Muchacho —gritó Hojalatero dirigiéndose al exterior.
cicatriz | El largo cabello negro se agitaba alrededor de su rostro oscuro lleno de cicatrices.
sentado | Se arrodilló para apoyar la mano en la tierra donde se había sentado la mujer.
piel | Los viejos y las mujeres permanecían sentados a la entrada de las tiendas hechas de pieles.
estandarte | Guiñó los ojos y miró al jinete más cercano, estandarte de piel gris.
temblar | Los estandartes de poder temblaron como si los hubieran golpeado.
altura | A esas alturas la juramentada se había sentado en el suelo.
segundar | La segunda noche en el río después de eso empezó a preocuparse.
bravo | Diente Bravo le pidió que se acercara más con un ademán.
referir | La recordarías si la vieras, ya sabes a qué me refiero.
magistrado | —¿Fuerzas? ¿A qué fuerzas podría referirse usted? —preguntó el magistrado Plengyllen.
miembro | Magistrado Plengyllen, miembro de la Corte Suprema de Magistrados
ofrecer | La soldado se echó el escudo a la espalda y le ofreció el brazo.
objetivar | No tiene sentido ofrecerme como objetivo a lo que sea que aguarde oculto allí dentro.
asomar | Avanzaron arrastrándose y se asomaron para mirar el objetivo.
hueso | Los huesos de muchos guardias pueblan estos bosques del norte.
negar | Zarigüeya se negó a reconocer la atención.
amenazar | Todo el mundo hablaba a la vez, se quejaba, amenazaba, se negaba a moverse.
ademar | Además, a estas alturas me imagino que ya hace tiempo que se habrán ido.
menor | —Y además, ¿de dónde sacaste eso? —preguntó Menor.
encorvar | Se sentó encorvado, rodeándose con fuerza los brazos como si quisiera sujetarse el cuerpo.
recibir | ¡Que Viento me salve! Se fue echando hacia delante, encorvado para recibir pesados golpes.
izquierdo | Diente Bravo se pondrá a nuestro mando por la izquierda.
carne | Encuentro que me estoy haciendo más duro, pierdo carne, por así decirlo.
vengar | —¡Oh, dioses! ¡Venga ya, Seda! No hablarás en serio…
colgar | —Si la emperatriz se echa al campo de batalla, entonces Heng ya se puede colgar sola.
pechar | —Frotó la saquita que le colgaba del pecho—.
toser | Un segundo liosan se sentó también, tosía y se apretaba el pecho con cuidado.
despertar | Despertó tosiendo y escupiendo en una cubierta dura.
explorador | Al ver a Kyle despierto, el explorador rezongó y se apartó.
murar | Un gran muro de aire quitó el aliento a Trémula de un golpe en el pecho.
refugiar | Seguid corriendo, muchachos, buscad refugio, porque lo peor acaba de llegar.
sanador | No os molestéis, queridos sanadores, en despertarme.
traer | —Traed un sanador —les pidió Laseen a los soldados que habían llegado corriendo.
enorme | Los kanesianos se encogieron, los ojos enormes bajo los bordes de los yelmos.
forma | Unas formas oscuras cruzaban el cielo, muy lejos, enormes y pesadas.
burlón | Los otros sargentos de saboteadores se alejaron sin prisas, Gant ofreciéndole una carcajada burlona a Noche.
guantelete | Había perdido un guantelete, se limpió la cabeza fría.
soltar | En cuanto soltó la piedra algo cambió en los terrenos.
intención | Y no creo que tengan intención de soltar ni una cosa ni la otra.
recoger | —Manos recogió el dado de hueso.
arco | Recogió el arco y se irguió.
escudo | Espadas y escudos solo, nada de armaduras, arcos o ballestas.
apilar | Apoyaron los escudos en las maderas apiladas y cogieron las ballestas.
carga | Arrojo se asomó por encima de la carga apilada.
rugir | Con un rugido, el primero de los pelotones entró a la carga.
herida | Risueño rugió cuando cayó con todo el peso sobre la pierna herida.
brecha | Bajo Ereko se reveló una brecha, una herida en la oscuridad.
derribar | Una tropa de caballería falari llegó a la carga y pasó derribando escaramuzadores.
bestia | Si aparece la bestia, todos caeremos sobre ella y la derribaremos.
preparar | —Sube arriba y prepara a la bestia —le dijo a Nervioso.
importar | Lo que importa es que este no es vuestro sitio.
ocurrir | Lo único que importaba era lo que ocurría.
semejante | Si supieras algo de la Guardia jamás se te ocurriría semejante idea.
través | Trémula se asomó a través de una brecha en las maderas.
campamento | Parecían estar esperando algo mientras observaban el este, el campamento imperial.
dorado | la razón de que se llamaran colinas Doradas
escoltar | Los escoltaremos hasta las colinas Doradas.
grupo | La escolta de la primogenatrix rodeó a todo el grupo.
siguiente | Su mirada se posó en el siguiente hombre de la fila.
notar | Lo siguiente que Kyle notó fue su altura, apenas le llegaba a él a la barbilla.
calentar | Arrojo incluso notó el maldito caliente en las manos.
herrar | El hierro todavía está caliente de cuando lo aplastaron.
dudar | La veterana dudaba de que aquel hombre hubiera llevado tanto hierro en toda su vida.
brillar | Un brillo trémulo de aire calentado y apareció el anciano, que se inclinó.
proa | Estaba entre las olas y se apoyaba en la proa del barco.
aceptar | Entonces te haré el favor de aceptar que todo esto lleva a alguna parte…
convertir | Una mirada salvaje del antiguo sargento, convertido ya en capitán.
sospechar | Sospechaba que eso convertía a los juramentados en algo parecido a una especie extraña y aparte.
lejano | Arrojo sintió el movimiento de algo lejano que estremecía el suelo bajo sus pies.
empujar | El juramento seguía empujándolo, de eso estaba segura.
sol | El sol le calentó la espalda y pareció empujarla a continuar.
aclarar | Se aclaró la garganta en el puño izquierdo.
balar | —Demasiada amenaza, ¿eh, Bala? —dijo Heuk.
amplio | La carcajada de Bala hizo temblar su amplio pecho.
mostrar | La sonrisa de la mujer era amplia y mostraba unos dientes grandes y blancos.
puente | Los magistrados bajaron el puente con paso decidido.
mil | La sombra examinó el puente y los miles que había detrás.
según | Unos tres mil, según había oído, y quién sabía cuántos juramentados entre ellos.
información | Según nuestras informaciones cuentan con una «escolta» de más de cuatro mil hombres.
restar | El resto de la información tendría que esperar, quizá para siempre.
carta | Pero según los informes, Cogulla y los velos tienen carta blanca.
equipar | —Regalo va a recoger al resto de nuestro, eh, equipo, esta noche.
comida | ¡Tienen comida caliente, según he oído! Venga, vamos.
manta | —Peor para usted; bueno, he traído comida, mantas.
centrar | Del mismísimo centro del Imperio de Malaz.
invitar | Era obvio que estaban invitando a un ataque por el centro.
asentimiento | Un asentimiento largo y lento.
reverenciar | Recibió con un seco asentimiento la reverencia de todos.
colar | Cole los invitó a pasar con un ademán e hizo una reverencia.
arder | El humo le envolvía el pelo, que parecía arder sin llama.
escapar | De verdad esos dos podían escapar cuando lo deseasen
tambalear | Solo Temp seguía de rodillas, tambaleándose de un lado a otro y con la cabeza hundida.
armar | Un giro y el arma le colgó a la espalda.
fácil | Al fin sabía que le resultaría mucho más fácil usar el arma que llevaba al costado.
magro | —Cole —susurró—, Amatt, Magra, Negro y Turgal.
principal | —Tenemos que mantener el grupo principal contenido.
elegir | Ese hombre no estaba intentando solo matar, estaba eligiendo el objetivo
sendero | Se habían puesto en marcha por un sendero elegido.
inmediato | Bajaron de inmediato a un elegido korelri para ocupar su lugar.
comprender | —Caudillo, se comprendió desde el primer momento que no tomaríamos la ciudad de forma inmediata.
tela | Telas: el sendero de Fuego
clavar | Ullen se había apartado de la mesa y había clavado los ojos en la tela abierta.
vario | Noche se estremeció y se tambaleó cuando varios cuadrillos se clavaron en su escudo.
anillar | Cruzó el espacio que lo separaba del anillo principal.
disponer | Debería haber más, pero no es algo que ninguno de ellos parezca dispuesto a aceptar.
olvidar | Cada paso que dais os lleva más cerca del olvido que nos aguarda a todos.
alarmar | Varias manos señalaron, se dio la alarma y se dispararon ballestas.
escalera | El otro hizo un saludo militar y bajó corriendo las escaleras.
anunciar | —Muy bien —anunció desde el refugio de las escaleras—.
marinero | Subieron por las escaleras junto al marinero, que temblaba y no levantaba los ojos.
hermano | —Los barcos aguardan, hermano —anunció en taliano—.
v | —Comprendemos —dijo V’thell.
cinco | —Dejó las cinco cartas en el suelo y empezó a sacar otras y a explicarlas—.
figura | Al otro lado salían figuras de la oscuridad, cinco guardias carmesíes, todos juramentados, sin duda.
revolver | Tres figuras salieron entre el humo y el polvo revuelto: Ho sujetado por los jóvenes wickanos.
hechicero | El hechicero dobló los dedos pálidos, llamándolo.
confuso | El joven hechicero apartó la mirada del frente y por un momento pareció confuso, después sonrió.
encogimiento | Un fácil encogimiento de hombros.
pensativo | Un encogimiento de hombros lento y pensativo.
carreta | —Menor, Dulce Muchacho, sacad esta carreta de la calle.
desechar | Hojalatero se limitó a desechar la idea con un ademán y volverse hacia la carreta.
chacal | El hombre-chacal, hermano de Trake, dios de la guerra.
vigilar | puede enfrentarse a nosotros en el sur y vigilar como es debido el norte
amigo | —Uno de vuestros amigos está vigilando a mi pueblo, como debería ser —dijo Janbahashur—.
compañero | Dónde están sus amigos, sus hermanos y compañeros de armas
ceder | Las piernas de la mujer cedieron y su compañero estiró los brazos de inmediato para sostenerla.
estallido | Un grito rompió el silencio después del estallido.
corlar | Barras sorprendió a Corlo observando desde la proa.
reunido | Los oficiales reunidos y los mensajeros podían decidir si querían seguirlo o no.
vistazo | Genist les echó un vistazo a los oficiales reunidos, ninguno se reía.
tormenta | Echarle un vistazo a esa muralla de las Tormentas de la que habla todo el mundo.
gente | Juntos podemos defender a toda nuestra gente de estos ataques.
aspecto | El cielo tenía un aspecto extraño en el oeste.
oler | Rillish imaginó que su propio aspecto tenía que ser peor, desde luego olía mucho peor.
cejar | Kyle intercambió miradas con Acecho, Malas Tierras y Fochas y ladeó una ceja.
cabo | —Ah, es la cabo Talia, señor.
guiar | —Si es guía lo que desea, dile que no puedo darle nada que no tenga ya.
espíritu | Había asesinado a un espíritu que guiaba a su pueblo
queda | Te queda espíritu de lucha, por lo que veo.
completar | Déjame completar el último juramento que me queda.
instante | —¿Y ahora qué? En este camino los setis nos derribarían en un instante.
anchar | La mirada de Humo se posó un instante en la ancha espalda del hombre de proa.
bigote | Un ancho bigote negro le ocultaba por completo la boca.
ambo | El bigote blanco le colgaba a ambos lados de la boca crispada.
cuarto | Creemos que esta noche, antes del amanecer, el cuarto anillo caerá.
personal | Justo lo que los imperiales de su personal necesitaban oír.
exhalar | Un miembro de su personal se aclaró la garganta y Ullen apretó los labios y exhaló.
bocanada | —Exhaló una bocanada de aire larga y lenta—.
sinuoso | Sinuoso exhaló una larga y pensativa bocanada de aire.
deslizar | Sinuoso le abrió la armadura y le deslizó una mano por el costado—.
regular | La falta de espacio personal entre los regulares fue lo primero que sorprendió a Ghelel.
pozo | Al llegar al final del pozo, Noche fue subiendo para deslizarse fuera.
apretado | La mujer siseó una larga bocanada a través de los dientes apretados.
devolver | Le ofreció una sonrisa burlona a Harmin, que se la devolvió con los dientes apretados.
caos | Lo propio es que yo os devuelva una muestra de ese caos
abismar | Metiéndome en el abismo, o la brecha del propio Caos.
capaz | —Dile que mantenga a esos chamanes setis tan lejos como sea capaz.
cinturón | Manos se quitó los guanteletes del cinturón.
flotar | Mientras se alejaban flotando, Arrojo la oyó exclamar algo tras ellos.
oscurecer | Las olas los mantuvieron a flote y oscurecieron los cueros de Viajero.
tallar | La sangre oscurecía de carmesí las piedras talladas del puente.
llanura | Que mientras duren las llanuras, él seguirá vivo.
trepar | Después de trepar la ladera llegaron a las llanuras del norte.
trinchera | Los dos salieron trepando de la trinchera.
extender | El hombre estaba examinando el oscuro campo que se extendía ante la trinchera.
envainar | Un cuchillo largo envainado permanecía metido en el cinturón.
suerte | Cualquier idiota puede tener un golpe de suerte con un arco.
acompañar | Deseó a Urko que lo acompañara la suerte con su frente de escaramuzadores.
recado | Se mandará recado una vez que la flota esté en mar abierto.
brillante | Hicieron girar las monturas unos junto a otros, las espadas brillantes bajo la luz fría.
dispersar | Permitieron que pasaran nuestros dos barcos, pero al resto los dispersaron.
nube | Después pasaron las nubes y las sombras se dispersaron.
gruesa | Los cielos se oscurecieron, las nubes bajas y gruesas se revolvieron.
manchar | Otra mancha o nube oscura ocultaba el centro.
irregular | Todos los juramentados retrocedieron en esa mancha irregular y desaparecieron, dos sujetando a Despellejador.
gemir | Más abajo, en la amplia llanura abierta se alzó un gran gemido entre los irregulares untan.
iluminar | La luz irregular de los fuegos iluminaba las calles.
municionar | Hay moranthianos caídos ahí fuera y esos idiotas de irregulares están recogiendo las municiones.
bolsa | Arrastraba las bolsas de municiones a ambos lados.
bota | —Molk se arrodilló, revolvió en las bolsas y sacó una bota de agua.
estallar | Se sacó una pequeña bota de agua del cinturón, vio que había estallado y la tiró—.
volar | Volaban los cuadrillos de ballesta, estallaban en el aire y hacían agacharse a Noche.
llama | Al instante, su sobrevesta estalló en llamas.
pedazo | Habían volado en pedazos la puerta exterior.
roco | Las llamas salieron disparadas de las manos por la roca húmeda.
arrancar | Uno de estos días, Manos, te voy a arrancar esas viejas botas.
apuntar | Regalo le arrancó la lanza al más cercano y apuntó con ella a Yath.
sólido | Arrojo lo ayudó a levantarse y tuvo que gemir bajo el peso sólido del veterano.
cometer | En un momento dado un escudo salió volando por los aires como una cometa.
caja | Arrojo estudió las cajas apiladas unas encima de otras, posible.
botar | —Cogió la bolsa que habían tirado y corrió a buscar un bote.
retaguardia | ¡Estaba ganando terreno! La tierra iba cayendo cada vez más cerca, avanzando sobre su retaguardia.
lanza | Las filas de la retaguardia retrocedieron con las lanzas levantadas, observándolos con atención mientras se alejaban.
significar | —Significa que puede que estén aquí para intentar tomar Li Heng.
mierda | —Mi nombre no significaría una mierda para ti.
mañana | —Pues haznos un favor y déjalo para mañana —rezongó Risueño por lo bajo.
general | V’thell se inclinó ante el general.
multitud | Zarigüeya se apoyó en el muro, de cara a las espaldas de la multitud.
dedicar | Todo a lo que habían dedicado sus vidas y sus muertes.
aliviar | Le alivió ver que Nada le ofrecía una sonrisa conocida.
joder | ¡Tan rápido! Y además maga, y muy buena, joder.
ascua | No necesitan ningún jodido puente de la jodida Ascua.
helar | —¡Ascua nos libre, muchacho! No debemos tocar ese hielo.
posibilidad | —Despellejador desechó la posibilidad con un ademán—.
mandíbula | —Creí que los setis estaban todos con el chacal —le susurró Mandíbula a Noche.
crujir | Movió las mandíbulas, que crujieron y estallaron y, de algún modo, Kyle comprendió sus palabras.
silla | Arrojo se volvió para mirar atrás, el cuero de su silla crujió.
retorcer | La pierna le gritaba de dolor y lo hacía retorcerse en la silla.
carrero | Ogilvy se acercó a la carrera, una sonrisa llena de dientes retorcía su cara redonda.
funcionar | Las mandíbulas del mensajero se pusieron a funcionar cuando se tragó el resto de sus palabras.
zanjar | Zanja se acercó a la carrera.
conmocionar | La multitud que los rodeaba se tensó, conmocionada, y retrocedió un paso para dejar más espacio.
reinar | —¡Que la Reina lo lleve! —Penas se había levantado.
ancestral | Todo en el nombre de la diosa ancestral de ese reino, la reina Ardata.
viejo | Choss, vieja guardia malazana, antiguo puño supremo
historiar | Es una vieja historia, una historia que esperaba haber dejado atrás.
vencer | ¡Vencer! Ya habrá tiempo de sobra después para rescribir la historia y quedar bien.
niño | Era la segunda vez que esa niña-mujer lo vencía.
estómago | Entonces el hombre se inclinó con un brazo en el estómago y el otro extendido.
flanco | Sus espadas encontraron el flanco oeste hecho pedazos.
sudoroso | A su lado, era a Acecho al que le costaba respirar y tenía el rostro sudoroso.
fullero | Zarigüeya miró a un lado: cuatro saboteadores lo apuntaban con ballestas; en cada una, un fullero—.
jadear | Al verlo despierto, un marinero se acercó secándose la frente y jadeando.
vivar | Cuando pase todo, mujer, si todavía sigues viva… te mataré con mis propias manos.
gigante | —En la Guardia oí hablar de gigantes que viven en Stratem.
sacudida | El gigante dio una sacudida seca a la cabeza.
brusco | —Humo alentó a Ogilvy a adelantarse con una brusca sacudida de la cabeza.
extranjere | Todos ellos se habían ido a luchar en guerras extranjeras y muy pocos habían regresado.
mente | —Bueno, ¿quién puede decirlo? Sus mentes trabajan de formas extrañas.
resto | ¿En serio? Melena Gris… —Examinó los restos, pero era obvio que su mente estaba muy lejos.
problema | —Quiero decir que podría hacer caer todo tipo de problemas sobre nuestras cabezas.
rango | Cree que el rango es un problema.
noble | Miembros del personal militar, soldados de alto rango y nobles iban y venían.
familia | La caballería imperial (muchos luciendo los estandartes de sus propias familias nobles) se ponía en marcha.
pronto | ¿Quién es? ¿La familia Adal llega pronto de Tali? Debería cambiarme.
tirón | Apartó la mano de un tirón, alarmado.
rodar | Arrojo agachó la cabeza, ¡el tirón de la Señora! Rodó de espaldas.
inclinación | El caudillo le dedicó a Arrojo una pequeña inclinación.
media | Tras una especie de media inclinación, Noche empezó a bajar la ladera.
demás | Un hombre para el que las vidas de los demás no significaban nada.
lluvia | Y con la lluvia, la oscuridad y demás, fue fácil.
espumar | Entre la espuma distinguió a varios jinetes que rodeaban el barco.
estrechar | La espuma del estrecho volvió a recuperar todo su poder.
nariz | Pero la nariz era demasiado larga, la cabeza demasiado estrecha.
arrugar | Arrugó la nariz… con todo, la verdad era que olía a mierda.
asunto | Mejor mantenía las narices fuera de ese tipo de asuntos.
roncar | —¿Tú eres el explorador Kyle? —chilló el mago con voz ronca.
tratar | —No des las gracias por un trato justo —fue el susurro ronco—.
advertir | —Será mejor que sea bueno —advirtió, la voz ronca de gritar órdenes—.
término | Pero te lo advierto, es posible que pida ciertos términos.
cumplir | —Hablo ahora porque los términos de mi acuerdo con mi amigo ya se han cumplido.
manchado | May se acercó corriendo, encorvada, las manos manchadas de sangre de tratar heridas.
túnica | Tras un rato, el tipo bajó la suya y se la limpió en las túnicas manchadas.
barro | Una túnica desgarrada llena de barro.
desmontar | —Un hombre desmontó, sus botas golpearon el barro.
peligroso | Dígales que los setis advierten de una presencia peligrosa en la noche.
bruja | Tengo entendido que hay muchas brujas y hechiceros entre los wickanos.
contemplar | El brujo había echado la cabeza hacia atrás para contemplar las nubes.
rogar | Las voces rogaban agua, un alivio.
liberar | Lo sé porque si tuvieras la menor idea, ya habrías venido a rogarme que te liberara.
jugar | Así que él les seguiría el juego en aquella historia.
ritual | Llevaremos a cabo un ritual para movernos por sendas con el barco.
muelle | Las llamas envolvían los muelles de Kurzan.
miedo | Por supuesto no mostraba miedo alguno, pero Ereko estaba preocupado.
quietar | —Y se alejó otra vez, llevaba quieto en un solo sitio tiempo suficiente.
recién | Liossercal se quedó quieto y se volvió poco a poco hacia el recién llegado.
árbol | Lo que esos árboles son para el Azath, lo mismo es este bosque para Sombra.
estrépito | Sacaron las armas con un estrépito de hierro que resonó por toda la línea de árboles.
chocar | Un choque y el estrépito del hierro en las piedras revelaron una garganta o ladera cercana.
navío | El otro navío chocó con el suyo.
abandonar | El navío abandonado no tardó en hundirse.
rondar | Se decía que iban a abandonar toda la ronda Exterior.
torrar | —Escupió por el borde de la torre junto a la puerta Sur de la ronda Exterior—.
gruñido | Volvieron a chocar, con gruñidos de esfuerzo y golpes capaces de derribar árboles.
edificio | Los edificios que ardían cerca de la muralla de la ronda Interior iluminaban la noche.
fondo | Arrojo, Nervioso y yo hicimos un pozo hasta el fondo de la zanja.
maestro | Maga peligrosa, maestra de la senda D’riss.
cabalgar | —No está tan mal si guiñas mucho los ojos —comentó el hombre que cabalgaba detrás.
futuro | Debería golpear ya, pero no puedo olvidar lo que aguarda en el futuro.
evitar | He de observar a estas gentes para saber qué debo evitar en el futuro.
ruina | Los edificios cercanos ardían en ruinas.
costa | La mañana siguiente vio una costa de ruinas.
derecho | Se esforzaba por regresar a las ruinas, pero era incapaz de caminar derecho.
recorrer | Ereko se irguió en toda su altura y recorrió la costa con los ojos.
resistir | —¡Resistid! —bramaba el sargento mayor a la derecha de Noche—.
patio | Las sombras dispersas del patio en ruinas parecieron parpadear y cambiar.
soslayar | Arrojo se limitó a mirar de soslayo el lugar donde Ameron había arrojado su equipo.
humeante | Todos y cada uno de vosotros, preparad una saquita con fulleros, humeantes y demás, cuanto tengamos.
contigo | Pero sé que él siempre estará contigo, pase lo que pase.
adónde | —¿Y tú, adónde vas? La hermandad no hablará contigo.
mellizo | ¿Adónde vais? ¿Qué estáis haciendo aquí fuera? Por el giro de los Mellizos, hombre.
brujo | Ho le dedicó a la vieja bruja un guiño cuando los mellizos la ayudaron a irse.
calmar | Los mellizos permanecieron sentados en silencio, dejando que la tormenta se calmara sola.
convencer | Mallick esperó hasta convencerse de que la vieja bruja se había ido.
unidad | Era obvio que veían que era su única oportunidad para romper las unidades imperiales.
misterio | —¿Mallick? ¿Ha dejado Unta? —Desechó el misterio con una sacudida de la cabeza—.
sonar | —¡Comandante! —chilló, o a él le pareció que había gritado, sonaba muy lejana.
pensamiento | Zarigüeya se sonó una vez más y desechó a Anillo de sus pensamientos.
ve | —Eso es algo que no se ve todos los días —oyó Kyle que jadeaba el hombrecito.
parte | Ves enemigos por todas partes.
espiar | Los espías que has puesto por todas partes nos informan a nosotros también.
invocar | El espía se calmó e invocó su senda.
magia | Despellejador ha invocado magia ritual y los imperiales han respondido.
mitad | cómo iban a hacerlo si no podías usarlas la mitad del tiempo
jurar | La mitad de los hombres que he matado se habían jurado a Togg, igual que yo.
talento | Claro que no recuerdo que ningún talento terminara ahí arriba.
guardar | —Las gruesas manos del talento temblaban cuando guardó las cartas.
asediar | Suficiente para muchas torres de asedio.
manera | No, la mejor manera de aliviar el asedio sería tomar el campo de batalla.
banda | Enviad recado a las bandas de guerra.
aliado | Incluso teníamos aliados barghastianos nosotros también, esos chicos luchan contra cualquiera, en cualquier parte.
desdar | El desdén de la niña era absoluto.
despacio | Sacaron espadas y empezaron a separarse muy despacio para rodear a los dos.
sorpresa | Aron se permitió alzar las cejas como si dudara en la sorpresa.
herir | —¡Es un navío seguleh! ¡Sí, eso es! Soltad las armas y nadie saldrá herido.
asesino | El mago supremo y maestro de asesinos de la Guardia contempló a Joroba en silencio.
arquear | Magra se volvió con una ceja arqueada hacia Kyle y los de la primera fila.
transmitir | Era como si estuvieran transmitiendo información y recibiendo órdenes del niño.
preocupación | Tus preocupaciones se transmitirán, fue la lejana respuesta.
dorar | La ceja sobre un ojo dorado se arqueó.
organizar | El teniente se dispuso a organizarlo junto con el sargento Acorde.
dama | Supongo que es todo lo que podemos organizarle a la dama.
sondear | La dama extendió sus sentidos para sondear aquella extraña presencia extranjera.
percibir | Percibió la presencia de Humo a su lado, sondeando, pero el mago se encogió de hombros.
interrumpir | —¿Qué perciben? —interrumpió el hombre de las túnicas.
espolear | Rillish maldijo y luchó por espolear a su sudoroso caballo.
rienda | Saludó al hombre con un asentimiento brusco, ladeó las riendas y espoleó su montura.
ajustar | Kyle la había ajustado metiéndole un trapo por dentro.
arenar | Kyle se ajustó el cinturón con su propio talwar y saltó a la arena húmeda.
barbar | —Pues no tiene muy buen aspecto —dijo Fochas mientras se limpiaba la arena de la barba.
destellar | —Esos malditos árboles se llevaron mi pierna —dijo, los dientes destellaban tras la barba.
precipitar | Unos fucilazos altos parpadeaban y se precipitaban por los cielos, saltando y destellando sin ruido.
captar | Eran sonrisas lo que había captado en los rostros de sus soldados
popa | En la popa captó la atención de Acecho, que lo llamó con la mano.
allá | Viajero miró más allá del joven, a la popa donde vigilaba Ereko.
desafiar | ¡Allá vamos! Los puñeteros magos juramentados llegaban para responder al desafío.
pared | Había un guardia sentado, apoyado contra una pared más allá de Joroba.
desnudar | La mujer echó un vistazo a las paredes desnudas.
plegar | La sonrisa se plegó en una mueca de desafío burlón.
manto | Kyle se sentó cerca de la popa y se envolvió en su manto.
palmar | Dulce Muchacho dio una palmada al barghastiano en la espalda con manto de bhederin.
muslo | Liss dejó escapar una carcajada ronca y se dio una palmada en un muslo ancho.
atravesar | Avanzó a pesar de un cuadrillo que le atravesó un muslo entero.
defensar | ¡Intentadlo todo lo que queráis, juramentados! Nadie atravesó jamás la defensa de la espada, su escolta.
conmigo | —Tengo cuatro mil regulares malazanos conmigo, puño.
discutir | —Discutirás el asunto conmigo.
pausar | Una pausa mientras los oficiales del estado mayor discutían.
camisa | Mientras se quitaba la camisa, Ghelel hizo una pausa.
vestir | Kyle se vistió con la camisa del gambesón.
color | Un pequeñajo vestido con colores oscuros estaba arrodillado sobre Risueño y ella.
azul | De hecho, la caballería vestía de color azul oscuro, los viejos colores talianos.
combatir | Y allí por donde marchaban sus ejércitos encontraban las filas de los guardias combatiéndolos.
eterno | Combate eterno que duraría hasta que el Imperio cayese.
bufido | —Entonces… —Con un bufido, el marqués tiró la tela en la mesa—.
error | Y después de un tiempo te das cuenta de que has cometido un error.
seguridad | —Puedes tener la seguridad de que, en tu caso, no cometo semejante error.
catarata | Se parecía a una enorme catarata que surgía en el aire vacío.
legua | Hizo retroceder la noche en media legua a la redonda.
deshacer | Nadie se acercará a menos de cien leguas de nosotros hasta que podamos deshacernos de él.
rumbo | Noche los guió de regreso, rumbo al flanco de las tropas de Diente Bravo.
aquél | Quizá debería limitarse a seguir caminando rumbo al sur, alejarse de todo aquello.
andar | Trémula se dio la vuelta y echó a andar.
círculo | —¡Juro que nos está haciendo andar en círculos! —dijo después, en voz más alta.
bruma | Un encogimiento de hombros del gigante, que no apartaba los ojos de la bruma.
crecer | La bruma pesada fue creciendo y cubrió el patio.
provocar | La lluvia siseó y provocó una bruma en la hoja.
empujón | —Entonces ponedlos a disparar, ¡disparad! ¡Ahora! —Los apartó a los dos de un empujón.
remo | Olo preparó los remos y se apartó con un empujón del muelle.
usted | —Ustedes, los quontalianos, parecen tener miedo de todo.
derramar | Están ustedes derramando su sangre en defensa de nuestra tierra.
tapar | Quedó tendido con los brazos tapándole la cabeza, gritando sin palabras y rogando que terminara.
bastón | La madera del bastón crujió en las manos de Yath.
orar | Empujó el sol de oro.
moneda | —Asunto mío, ¿no le parece? —Y el tipo sacó una moneda de oro.
preciar | —Dejamos un precio justo en monedas y cogimos los peores de la manada.
menudo | Menudo precio que alcanzaría semejante hombre de armas
abertura | Una figura menuda se deslizó por la abertura y Ghelel se la quedó mirando.
plantar | Encontraron una abertura que llevaba a una planta baja vacía y unas escaleras que subían.
renegar | Ese renegado, Melena Gris, no parece muy convencido.
aguas | El renegado había fruncido el ceño, su mirada pálida se había clavado en las aguas.
salar | Parpadeó ante el brillo de la sala.
probar | El mar más salado que he probado jamás.
concentrar | Muy pronto los irregulares serían libres de concentrar el fuego una vez más.
tranquilizar | ¡Concéntrate! Intentó centrarse, tranquilizarse.
patada | Vendrán y lo derribarán de una patada.
sandalia | Todo el mundo lo siguió, quitándose a patadas el barro de las sandalias y las botas.
aterrar | Las ratas chillaban, aterradas, en el agua, y los hombres maldecían y las apartaban a patadas.
agrietado | La piel de todos está en carne viva, agrietada y sangrando de frotarla tantas veces.
quemar | Todos los de piel clara se habían quemado y tenían la piel agrietada y sangrando.
agudo | Un estallido de carcajadas agudas.
chillido | —Se están largando —exclamó Nervioso, su voz se hizo más aguda, casi como un chillido.
penar | —Diría que es una pena, porque es todo lo retorcida que hace falta.
merecer | Pues claro que sospechábamos que había algo aquí arriba que merecía la pena.
isla | Pero está funcionando, eso y haber dejado las islas muy atrás.
hija | Hija de la propia Vorcan Raddock, la mejor asesina de esa ciudad.
obligar | Luchó por obligarse a seguir a las dos figuras que se alejaban.
t | —No llevaban tales escudos cuando los obligamos a meterse ahí, T’enet.
ojalá | —Me hace pensar que ojalá la bestia cruzara el Idryn —dijo Razala entre dientes.
direccionar | En qué extrañas direcciones vuelan los pensamientos de este hombre.
raro | Se dicen cosas raras cuando la vida huye.
necesario | Necesita los fondos necesarios para hacerlo.
firmar | Y será necesaria una mano firme para detenerlos…
principiar | Rápido al principio y después más despacio, fue dando golpecitos hasta que chocó contra algo firme.
campaña | En todos los años de campañas que llevaban juntos, todavía tenía que verle un solo corte.
leyenda | Leyendas vivas de la campaña de Siete Ciudades.
realidad | —Hay leyendas, pero nadie ha visto en realidad…
humor | Ereko yació despierto, escuchando la noche y percibiendo el humor de esa nueva tierra.
galera | Barras examinó las cubiertas de la galera de guerra, pero no vio movimiento alguno, aunque cedió.
áspero | —Juega a un juego muy peligroso, Ameron —consiguió decir, tenía la voz áspera, ronca.
playo | Bajo las sandalias de Kyle, la playa se agitó y revolvió.
perplejo | Perplejo, Ereko acompañó a Viajero y al anciano cuando recorrieron la playa.
importante | Lo importante es que si la aceptan, la defenderán.
confiar | —Confío en no haberme perdido nada importante.
descansar | —Confío en que hayáis dormido bien y estéis descansados.
representante | Sus representantes están abiertos a la posibilidad.
matanza | La matanza se extendía casi una legua en todas direcciones.
puto | Cierra la puta boca del abismo.
dibujar | —¡Juramentados! —chilló Trémula al tiempo que alzaba los brazos y dibujaba un círculo completo—.
rozar | Cuando sus pies rozaron piedras talladas, se detuvo.
lona | Pondremos una de las lonas que sobran o unas mantas.
grueso | La gruesa lona siseó y se rozó.
apagar | Cuando el grueso del ganado pasó, el ruido se apagó.
cuerda | Disparaban cuerdas de llamas que no tardaba en apagar Seda.
enseñar | —¡Lo reconoces! Me enseñó mi padre.
velocidad | El bote perdió velocidad.
preboste | —Créame, preboste, no es eso lo que desea.
presentar | —Permíteme presentarte a la preboste Alil, una nueva oficial.
salivar | Tragó saliva para hablar y dijo con voz áspera:
sudor | Jemain se limpió el sudor frío de la cara y tragó saliva.
remar | Olo cogió entonces los remos y remó como si le fuera la vida en ello.
ahogar | Una ola podría ahogarnos antes, en cualquier momento.
apagado | Una pausa de silencio y luego las botas se retiraron, voces lejanas y apagadas.
antorcha | El sargento dirigió la atención de Arrojo a una antorcha que había cerca, casi apagada.
contrario | Las antorchas de la guardia iluminaban la orilla contraria de Idryn.
arrugado | —¡Arrugada! —Una sombra que permanecía contra la pared contraria se adelantó y se alzó—.
ensangrentar | Magra se giró otra vez, las cejas ensangrentadas arrugadas.
mejilla | Recuperó el aliento, se tocó la mejilla y sacó la mano ensangrentada.
gesto | Las mandíbulas de Ryllandaras se movían, las garras de las manos ensangrentadas hacían gestos.
rígido | Una figura con armadura desmontó despacio, con gestos rígidos.
bienvenido | Pero ¿qué hay de ti? ¿Estás seguro de que no quieres venir? Eres muy bienvenido.
lograr | —Ojalá tuviéramos más hombres para lograrla.
necio | ¡Necia! ¿Qué lograste con eso? Solo conseguirás romperte los huesos del pie.
horrorizar | —¡Necio! ¡Eres un juramentado! ¡Nunca morirás! —El hombre parecía horrorizado de verdad.
valor | Pero para envainarla debería detenerse y tampoco tenía valor para tirarla.
carraspear | Ghelel se armó de valor y carraspeó.
ventana | Se le ocurrió que aquel sitio no tenía ni una sola ventana.
primera | Una ventana abierta dejaba entrar la luz de primeras horas y el aire.
postura | El muchacho cambió de postura, se estiró y despertó con un parpadeo bajo las primeras luces.
barrera | Su chillido se interrumpió en seco cuando cruzó la barrera.
llamada | Un ritual de algún tipo, una llamada ancestral.
puño | Los puños de Kyle apretaron la camisa.
hondo | Korbolo abrió los puños y se obligó a respirar hondo.
costado | Los guanteletes se convirtieron en puños a los costados.
aferrar | Todos los demás estaban sentados o se aferraban a las cuerdas o a los costados.
empuñadura | Dolor retrocedió de un salto y aferró la empuñadura de una espada.
animar | Con los ojos en el sargento mayor, que le guiñó un ojo para animarlo, Noche carraspeó.
hinchar | —El monito se animó, hinchó el pecho y se fue con paso decidido.
atraer | Los gruñidos, los golpes y el resonar del hierro los atrajo.
entornar | que parecieron no notar la atención de su señora mientras examinaban el entorno
destinar | —El comandante V’thell pide una vez más que se le informe de nuestro destino.
importancia | Una muestra para nuestros nuevos amigos destinada a convencerlos de la importancia de nuestro trabajo.
expresar | D’Ebbin hizo un pequeño ademán para expresar que no tenía tanta importancia.
curva | Como uno solo, los dorados sacaron sus pesadas hojas curvas y avanzaron.
arañar | Empezó a arañar la hoja curva.
velero | Cuando la proa arañó la arena, Viajero saltó entre las olas para sujetar el velero.
cargar | Están aquí para ayudar a cargar vuestro velero.
desplegar | ¡Cargad las ballestas! ¡Desplegaos! —Manos indicó que retrocedían.
vivir | Aquí, en las llanuras, si deseas vivir, harás lo que yo diga…
difícil | Joder, qué nombre tan difícil.
sirviente | —Verás que soy mucho más difícil de matar que mis sirvientes.
asamblea | El representante de la Asamblea tendió la tela y un sirviente la cogió.
diez | Tras haber disparado, los diez se arrodillaron y se irguió una segunda fila.
imbécil | Y daba igual que ella trabajara diez veces mejor que los imbéciles de sus hermanos.
plan | Claro que, todos habían sonreído como imbéciles cuando Acecho le había contado el plan a Zanja.
viajar | Según nuestro plan, os escabulliréis y dejaréis atrás todo eso durante el viaje por el río.
apresurar | —Diles que si apresuran nuestro viaje, recibirán lo que pidan.
túnel | La bruja wickana iba abriéndose camino con el bastón por el túnel irregular.
hijo | —¿Cuántas veces tengo que decirte que no hagas eso, hijo? Te va a sentar mal.
distante | —¡Bienvenido, Topper! —oyó Lurin que exclamaba el espíritu, la voz distante.
sobresaltar | Ho se sobresaltó, conmocionado.
suavidad | Con suavidad, Denuth giró al ser y solo para sobresaltarse, asombrado.
descender | Más adelante, el terreno descendía con suavidad.
gordo | Los labios del gordo se plegaron y, pensativo, bajó la mirada.
superficie | Muchos señalaban cuando los jinetes salían a la superficie en el estrecho, muy lejos.
acaso | Pero, ¿y Viajero? ¿Acaso no estaba por encima de tales preocupaciones? Era obvio que no.
lerdo | —Vigilaremos de cerca —lo tranquilizó Lerdo—.
timón | El juramentado respiró hondo y él y Lerdo dejaron el timón en manos de Devaleth.
poderoso | Un espía con aliados poderosos.
opinión | —En mi opinión, simples espíritus poderosos.
despedir | Dolor parecía a punto de decir algo, pero luego cambió de opinión y despidió a Ho.
oficiar | —La verdad es que los chicos y yo nunca estuvimos hechos para este oficio de mercenarios.
cintura | Seguía teniendo los brazos gruesos, la cintura pesada.
colocar | La mujer dalhonesia se inclinó y se colocó bien las túnicas.
perseguir | ¡Cómo se persiguen siempre! Sombra está presente, creciendo con el tiempo.
relajar | —Relájate, traeremos un sanador.
partida | Estoy seguro de que su intención es regresar de inmediato con su partida de exploradores.
arriesgar | Viajar allí es arriesgarte a meterte sin querer en otro reino.
preferir | —Yo prefería arriesgarme con esto antes que con Caos, sí.
aterrador | Que ella había cometido un error aterrador que la perseguiría durante el resto de su vida.
chapotear | Un chapoteo seguido por un jadeo agudo y después un silencio largo y aterrador.
abalanzar | Los dos kanesianos que tenía enfrente y las filas de detrás rugieron y se abalanzaron.
digno | Al final alguien digno de su atención cometería un error y entonces él se abalanzaría.
cimar | Topper se abalanzó y se aferró a la cima del muro de piedra.
irritación | Estaba ahogando una carcajada, tuvo que reconocer Mallick con un extraño destello de irritación.
beber | Pero el hombre seguía sin levantar la cabeza, no quería beber y mucho menos comer.
portavoz | —Usted no, portavoz de la Asamblea.
desperdiciar | Yo diría que los malazanos desperdiciasteis de forma necia vuestro talento.
triste | Un triste desperdicio, la verdad.
cara | —Estudió las caras de su pelotón mientras se abrían camino entre la hierba fría y húmeda.
agarrar | Risueño la agarró por el hombro y tiró de ella hacia el borde de las cajas.
ropa | Lo agarró por el cuello de la ropa y lo arrastró ladera abajo.
cuál | ¿Cuál era el problema? La lluvia le golpeaba los hombros.
clavado | El sargento se quedó muy quieto, con los ojos clavados en el portavoz.
despejar | Yació allí, con los ojos clavados en el cielo despejado de un color azul brillante.
asegurar | Creo que se aseguró un puesto como puta de un oficial.
éxito | Pregúntale a nuestra amiga korelana; con su ayuda, el éxito está asegurado.
consejo | y le estaba pidiendo consejo el hombre más poderoso del Imperio
aspirar | El hombre aspiró una profunda bocanada de aire, como si buscara por dónde empezar.
decisión | Mi oficio… Ahora se enfrenta a una decisión importante.
calma | Al acercarse al anillo notó la calma; al parecer por fin se habían tomado decisiones.
espadachín | —Has hecho todo lo que podríamos haber esperado y más —le dijo al espadachín.
chaleco | En el túnel, Ho hizo una pausa y se puso el chaleco y las sandalias.
doler | Shell se estiró el chaleco y su rostro arrugado se crispó como si le doliera algo.
esperanzar | ¿Y qué? ¿Qué podemos hacer? Quizá solo tengan la esperanza de que nosotros sepamos adónde vamos.
explosión | La explosión del cierre resonó en la línea de árboles.
producir | y a cuántas leguas de distancia se habrá producido la explosión
pipar | Corlo se sacó la pipa de la boca.
cuadrar | A no ser que apareciera Tayschrenn, ella confiaba en el cuadro de magos de la Guardia.
pregunta | Fue obvio que a la mujer se le ocurrieron más preguntas, pero se las guardó.
plantear | ¿Qué haría? ¿Adónde iría? Había pasado demasiado tiempo sin tener que plantearse siquiera esas preguntas.
paralizar | Se estaba planteando regresar a la trinchera cuando se quedó paralizado.
montar | El hombre observó al moranthiano dorado cuando volvió a montar.
barricada | Ordenó que se montaran barricadas.
aceitar | —Huelo a aceite —exclamó un soldado desde la barricada—.
demonio | —No es ningún demonio —anunció en voz muy alta el sargento mayor Temp a la multitud.
fundir | Un demonio, los retorcidos miembros y las manos (llenas de garras) casi fundidos.
abrazar | —El hombre-chacal sigue vivo, Arrojo —dijo, sin dejar de abrazarse—.
temer | Ghelel se abrazó incluso más, como si temiera lo que podría pasar si se soltaba.
demostrar | —Esperaba demostrarle que no temíamos viajar solos.
siglo | Había pasado más de medio siglo desde la última vez que Trémula había visto Unta.
horrorizado | Sacudió la cabeza, horrorizada por la visión de siglos de matanzas.
cadena | —Pon a todo el mundo a trabajar preparando las cadenas.
techar | Una cadena de hierro negro descendía de la oscuridad del techo y continuaba pozo abajo.
galopar | La columna tomó velocidad y se perdió al galope en la más absoluta oscuridad.
entrelazar | Entrelazó las manos sobre el amplio estómago, después bajó la vista, como si se las estudiase.
falange | Las falanges de los flancos también avanzaron para cubrirlos.
recluta | Los nuevos reclutas, me imagino que los tendrán formando falanges en los flancos.
ligar | A media distancia surgió un gran grito desde la falange de la Liga, al norte.
provisionar | El equipo y las provisiones se movieron y rodaron.
saquear | Nervioso y Arrojo saquearon las provisiones de Risueño, que se retorcía, gruñía e intentaba recuperarlo todo.
quien | Es a él a quien estás desafiando.
continente | Ha partido el continente por la mitad, sea quien sea.
ciento | Lo que a Ghelel le parecieron varios cientos de hombres y caballos descansaban allí.
leer | —Pruebe con el oficial de guardia, el capitán Leen.
reluciente | Los ojos oscuros de los guerreros se habían clavado, relucientes, en el velero más alejado.
estrella | Las estrellas brillaban, relucientes y duras.
estrategia | —¿Nuestra estrategia de defensa? Una muy rara.
alegrar | Pero deberíais alegraros por lo que habéis logrado
murmullo | Un murmullo general se hinchó entre las tropas.
jabalí | Salvaje, o Jabalí, se dirigía en ese momento con paso decidido hacia el caballo de Musgo.
trozo | Cayó entre un estrépito de trozos cuando la presencia que lo animaba se retiró.
sucio | Se derramó buena parte por la barba y las túnicas sucias.
vuelto | Su guía, el tipo de la túnica sucia, había vuelto.
verde | Los tres se asomaron a las olas revueltas, sucias y verdes—.
desdibujar | El entorno se desdibujó, convertido en una mancha verde.
título | Veo que es posible que seas, de hecho, digno del título de mago supremo.
carecer | —Esos títulos carecen de significado.
tuyo | Nuestras informaciones nos indican que Laseen carece de caballería para enfrentarse a la tuya.
asco | Con un gruñido de desdén y asco, Arrojo se levantó de un tirón—.
blandir | Arrojo siseó de asco cuando, para apoyarse, no pudo evitar tocar las paredes blandas y húmedas.
ondular | Blandió su bastón y un muro de poder ondulado atravesó la cubierta.
calor | —¡Tú mismo! —rezongó Risueño y retrocedió protegiéndose la cara del calor.
imposible | —Así que desplegarse hacia el sur es imposible.
danzante | Kellanved y Danzante habían hecho asesinar a los últimos cuando tomaron Tali.
pagar | —¡Vete! Danzante ha acabado con demasiados de nuestros magos, aunque Cogulla se lo hizo pagar caro.
lamentar | Y voy a enseñarle a lamentarlo.
aprender | El hombre iba aprendiendo poco a poco cuál era su lugar, decidió Genist.
pescar | Limpió el pescado como pudo, lo colocó sobre las llamas y se sentó a esperar.
rendir | —Pero ¿qué te pasa, Barras? No pienso rendir sin más…
entregar | Y ahora ríndete y entrégame el mando de este barco, nadie más tiene que salir herido.
mensaje | Y a entregar un mensaje.
pizarra | —Esta nueva presencia se llama la Casa de Cadenas —continuó Pizarra—.
desviar | Carraspeó y atrajo su atención, que se desvió de la noche.
cobrar | Desviar los ataques estaba cobrándose todas sus fuerzas.
denso | Las nubes densas y revueltas parecieron retirarse como si cobraran fuerzas para un último ataque.
vislumbrar | A veces creía vislumbrar figuras que se movían por el denso bosque que lo rodeaba.
luna | Quizá la dama me tiré así una luna de cobre.
repentino | Entre las hierbas cobraron vida fuegos repentinos.
marear | El calor le provocó un sudor repentino, también un mareo.
atrapado | Figuras distantes se retorcían, atrapadas en el estallido repentino.
rastrar | El teniente imperial se rozó un rastro de sangre del corte de una mejilla.
rabioso | Quizá los magos vivos más peligrosos del continente, y rabiosos, puñeteramente furiosos, le parecía a él.
repetir | —Que los dioses lo maldigan —no dejaba de repetir—.
retirada | —Retirada lenta, teniente —repitió Toc—.
aguantar | Todo el mundo aguanta para cubrir la retirada.
horizonte | Un puñado aparecía y desaparecía en la oscuridad del horizonte sobre…
estrellar | De regreso con él, mientras examinaba el horizonte estrellado del mar, la mujer le respondió.
rabiar | Las provisiones se estrellaron contra los hermanos, que rugieron de rabia.
puro | Un destello de rabia pura, contenida.
raza | —Digo bien porque aquí todos descendemos de pura raza de la Guardia Carmesí.
inútil | Una raza antigua de esta tierra, un resto inútil de un pasado triste.
venganza | Ya se ha derramado bastante sangre en esta inútil venganza.
entero | Y así continuaba durante días enteros hasta que la tormenta se calmaba.
superar | El tal Dolor (¡qué nombres tan ridículos llegaban a ponerse!) parecía superar en rango a su compañero.
número | Yo diría que nos superan en número.
emperatriz | Al emperador casi siempre lo superaban en número.
ofender | Nada se estremeció, ofendido, y tensó las riendas.
ejemplo | Por ejemplo, largarse corriendo toda ofendida sin pensar bien las cosas.
añadir | —Sargentos —añadió Hojalatero—, que vuestros hombres sigan su ejemplo.
masar | —En masa —añadió Malas Tierras.
aullar | Aullando de rabia, Ameron cargó contra la bestia.
capa | Korbolo se irguió y se ajustó las capas de mantos para defenderse de la lluvia.
salpicar | No muy seguro, levantó la barbilla y señaló las olas salpicadas de hielo.
energía | Penas respondió abriendo su senda y la energía se desvió y salpicó como agua.
nudo | A mí me parece que ayuda a deshacer los nudos.
asombrar | El asombro hizo un nudo en la garganta de Kyle.
común | Como puede ver, nos enfrentamos a un enemigo común.
tronar | El trueno se estrelló y fue perdiendo fuerza por las leguas de llanuras que los rodeaban.
agazapar | El pelotón de Noche se agazapó hasta que la caballería pasó como un trueno, después continuaron.
frontero | Todo el mundo susurraba porque estaban agazapados en la frontera de Oscuridad.
centinela | —Hábleme de esos Centinelas de la Frontera.
animal | Mírate, agazapado en el barro como un animal.
casco | La tienda tembló con el tronar de los cascos.
soportar | qué animal podría soportar semejante caos
borroso | Unas formas borrosas se agazapaban entre el techo de nubes.
solver | Lo percibimos muchos de nosotros, trozos sueltos, vistazos, ahora que estamos lejos de las islas.
atar | A veces le ato cabos sueltos.
u | —Todos atan unos cabos u otros, son así en esa unidad.
escalofriar | Arrojo se quedó muy quieta, esforzándose por escuchar, y un escalofrío le recorrió los brazos.
totalmente | La visión provocó un escalofrío en Ullen, que se los quedó mirando, totalmente horrorizado.
olear | Una segunda oleada entró en combate, agachándose, sondeando.
arrojado | Estallidos cercanos de una oleada de municiones arrojadas disparó polvo y tierra sobre todo el mundo.
roca | Unas rocas arrojadas resonaron desde el arco y Arrojo se agachó.
risco | La observaron retroceder hasta que trepó por un risco de rocas caídas y desapareció.
interponer | —Se interpusieron entre mi venganza y yo.
agradecer | Pero si pudiera movernos un poquito, sin embargo, lo agradeceríamos.
ligero | La mujer agradeció el gesto con un ligero asentimiento.
placer | —Un placer ver… —dijo el que vestía los cueros ligeros de un soldado.
cojear | Armado, empezó a cojear hacia los restos—.
malo | De mala gana, cojeando, el hombre abandonó el muelle.
utilizar | Lerdo le tendió una manta, que el otro cogió con malos modos y utilizó para envolverse.
admitir | El capitán tuvo que admitirlo de mala gana.
curiosidad | Admito que yo también siento no poca curiosidad.
barrer | Este se hundió, de mala gana, en las hierbas barridas por el viento.
mapa | Varias de las paredes interiores habían quedado barridas del mapa.
borrar | —¿Borrando del mapa la mitad de Unta? —soltó el marqués de repente—.
ascendiente | Liossercal, ascendiente, llamado hijo de la Luz, también conocido como Osserc, Osric
seguramente | seguramente bajo amenaza de maldecir a una familia
asaltar | Seguramente intentarán asaltarnos esta noche.
soñar | Soñó que la oscuridad que llenaba su visión lo asaltaba.
pradera | Fuera, aspiró hondo el aire caliente de la pradera.
increíble | Increíble, imposible, pero el hombre estaba luchando por levantarse.
remero | Y, por increíble que pareciera, la galera se jactaba de contar con cuatro filas de remeros.
armado | Marineros y remeros subieron a cubierta también, armados con algo.
tejar | no tendría centinelas en el tejado armados con arcos
impedir | —Sí, si cumplís vuestra parte e impedís que cruce.
invadir | —¿Qué va a impedirles invadirnos y rodearnos? —preguntó un oficial.
interesar | Se podría decir que me interesan las armas poco comunes.
millar | Dios del Millar de Humores, del Millar de Caras, del Millar de Nombres.
infantería | Entonces apareció la infantería imperial, que avanzaba a la carrera desde el frente.
elemento | Los elementos de cabeza de las infanterías malazana, taliana y falari se estaban desplegando.
atrapar | Joroba atrapó la pipa con los dientes.
alta | Los habían atraído hasta allí dentro y los habían atrapado entre altas murallas.
pasillo | Ante ellos, un largo pasillo que terminaba en otras dos puertas dobles mucho más altas.
portal | Unos pequeños portales se abrían a todo el pasillo.
patrón | —Patrón, o comandante… una especie de maestro también —explicó Jemain.
posición | —Podrías ordenarles reunirse en esta posición —sugirió Zarigüeya.
nómada | Todos formaron en posición de firmes, algunos habían cruzado desde el Nómada.
tipo | Barras volvió a rezongar: «Puñetera velocidad que tienen estos tipos, sean quienes sean».
arena | Malas Tierras y Fochas saltaron sobre las arenas apiladas con las armas sacadas.
harapo | El otro sujeto miró atrás, la cabeza envuelta en harapos, ladeada casi hasta rozar las arenas.
disculpar | Y por ello debo disculparme, emperatriz.
pirata | Esos piratas acabarían con ellos en cuanto posaran las armas
ingeniero | Lo único que produce esa isla son piratas, no ingenieros.
respetar | —Hace tiempo que se toma nota de vuestra falta de respeto… ingenieros.
incorporar | ¡Silencio! ¿Cómo se atrevía? Rillish luchó por incorporarse, él le enseñaría lo que era el respeto.
codo | Rillish se incorporó, se apoyó en los codos y les devolvió la mirada.
entumecer | Toc cambió de postura el codo entumecido, lo estiró e hizo una mueca de dolor.
constante | Estaba entumecida, no notaba nada salvo un dolor constante y molesto.
rumor | Las sacudidas continuaron, se cerraron como los rumores constantes de una tormenta al acercarse.
abanicar | Las hierbas se inclinaban, se estremecían como si hubiera un viento fuerte constante… ¡un abanico! Bala.
oído | Rumores del pasado oculto de la senda susurraban en sus oídos.
cámara | La cámara estaba en silencio salvo por el rumor lejano y profundo.
habitación | Cuando regresaron a las cámaras interiores, los guardias llenaban las habitaciones.
pasear | Ese amanecer, Arrojo se paseaba por el pasillo junto a la puerta de la habitación.
encadenar | Había un hombre sentado y encadenado a una silla en el centro de la habitación.
prisionero | Llegaban encadenados, prisioneros de guerra.
pretender | El hombre se echó hacia atrás y esbozó una sonrisa que Aron sabía que pretendía tranquilizarlo.
aprovechar | Solo una leyenda de la que esta bruja pretende aprovecharse.
cadáver | Viajero había bajado y se había agachado sobre el cadáver.
basar | En la base yacían los restos rotos de un cadáver con armadura, muerto siglos atrás.
alimentar | Algunos animales pequeños habían buscado alimento en el cadáver, pero ninguna bestia más grande.
guarnición | —Bueno, ya veremos, ¿no? Si no hay guarniciones malazanas como dice el hombre, entraremos sin más.
sacerdote | El sacerdote despidió a Anillo con un ademán.
satisfacer | La cara oscura y arrugada del sacerdote de Siete Ciudades estalló en una gran sonrisa satisfecha.
flecha | por qué no limitarse a derribarlos con flechas y cuadrillos
andanada | Una constante andanada de flechas en llamas volaba por los aires.
insecto | Cuadrillos de ballesta y flechas saltaron de la hierba como insectos rabiosos.
ja | —¡Ja! Sí que giran, ¿verdad? Bueno, pues se lo están tomando con mucha calma.
astuto | Las cejas de Noche treparon hasta la frente; el joven asintió con expresión astuta y satisfecha.
derrumbar | Cederá por ese lado y terminará derrumbándose todo.
fortaleza | Quizá hasta podría derrumbar una fortaleza entera…
sobrino | Debería enviar a su sobrino a buscar algo de pescado.
consciente | Los ojos de la mujer no lo reconocían, no eran conscientes de nada.
caída | Varios chillidos acompañaron la caída.
bocado | Rillish se resistió, luchó, jadeó y chilló a través del bocado.
culo | —Estábamos pensando que si hiciéramos eso, podría darse media vuelta y lanzarnos un bocado al culo.
pisotear | Y esa mujer cayó hacia delante, en el suelo pisoteado y quemado.
esconder | ¿Esconderse? Pero ¿con qué fin? Se limitarían a pisotearla.
jabalina | Nuestros barghastianos la rodearon y le clavaron por todas partes jabalinas y lanzas.
azuzar | Una andanada de jabalinas los azuzó.
vaina | El resto azuzó sus caballos colina arriba, las espadas destellaban al salir de las vainas.
basta | Basta decir que si quisiera matarla, ya estaría muerta.
rechazar | Toma esta moneda, le ofrecí, pero él rechazó mi mano.
empapar | Llegó secándose las manos, empapado hasta la cintura.
agotar | El hombre le sonrió con gesto agotado, el cabello gris empapado de sudor.
pasajero | Su pasajero se había derrumbado en la popa, empapado en espuma.
barcaza | —Puede que haya oído algo sobre una pasajera en una de las barcazas…
maniobrar | Los soldados y los remeros maniobraron su barcaza hasta la orilla y se levantó una tienda.
pasarela | Mientras caminaban por la pasarela, Arrojo maniobró para colocarse junto a Seda.
dirección | —El espadachín examinó el horizonte e inclinó la cabeza para indicar una dirección—.
mástil | En la cima del mástil principal, un marinero examinó el horizonte y señaló una dirección.
confianza | Los mellizos, a toda prisa y con grandes voces, juraron confianza.
factor | —Necesitaréis contar con el factor sorpresa —dijo una nueva voz desde no muy lejos.
misión | Entonces sabría también si ese hombre podría terminar siendo un factor en su misión… o no.
ofertar | —¿Rechazaron la oferta? —preguntó Ameron.
terror | El primer oficial genabackeño parecía incapaz de hablar de puro terror.
sufrir | Lurin miró al otro lado del patio y sufrió una sacudida de terror.
corriente | Una ligera estela de la corriente y de repente se encontró a Viajero a su lado.
perezoso | Flotaron río abajo, al este con la perezosa corriente.
gigantesco | Seda se fue abriendo camino entre las aguas perezosas hasta que tocó la gigantesca cabeza.
trozar | Trémula entrecerró los ojos, pero solo distinguió un trozo más oscuro contra la noche.
auténtico | Pero la puño Rheena asegura que es auténtica.
pavor | Observaba y escuchaba igual que él, con el rostro desgarrado entre el asombro y el pavor.
resolver | Cuando volviera, el misterio se resolvería.
dialecto | Pero el dialecto que utilizaban era difícil de entender.
bandera | Entre la masa de fuerzas de la orilla se alzaron y agitaron banderas de señales.
frenesí | Abajo se agitaban con frenesí banderas de señales entre los elementos de la Liga.
papel | —Permaneció sentado, frotando con los dedos el papel doblado.
aproximar | Lo rodearon a cierta distancia, hasta que uno se separó de los demás y se aproximó.
máscara | —Lo intentaré, pero no sé leer sus máscaras.
miedica | —Vaya, pero si es nuestro viejo amigo el sargento Miedica en persona.
palanquín | Esperaron mientras el palanquín se aproximaba.
calvo | El palanquín de Bala los seguía, guiado por el gigantesco, calvo y sudoroso dalhonesio.
rascar | Ho se rascó la calva y se encogió de hombros.
rojizo | El capitán Tonley se rascó la barba rojiza.
estocada | Con todo, el dalhonesio seguía lanzando estocadas y atacando.
rebotar | Pero todas las estocadas se deslizaban, rebotaban en la armadura oscura y manchada del juramentado.
aturdir | Una jabalina arrojada rebotó en su yelmo y lo aturdió por unos instantes.
esquivar | Aturdido, apenas fue capaz de esquivar el ataque del hombre.
implacable | Los soldados de Kan se abalanzaron y los juramentados los recibieron con estocadas rápidas e implacables.
recurso | La Guardia ya había perdido suficientes recursos en ese abismo implacable de Assail.
replicar | —Sería un desperdicio de recursos —replicó Choss, que agitó la copa con desdén.
asfixiar | El peso de la espada que tiraba de él a la izquierda amenazaba con asfixiarlo.
asiento | Quién podría llenar ese asiento frío, duro, peligroso, o quién se atrevería
costumbre | Te eligió a ti para hablarte, como es costumbre entre los juramentados caídos.
basura | Los soldados estaban arrodillados entre la basura, cargando y apuntando.
pulla | La Guardia salió remando del puerto acompañada por pullas distantes y la basura que les arrojaban.
sordo | Pero la joven bruja hizo oídos sordos a su pulla.
machacar | Los hombres gritaron y la madera se partió con un crujido lento y machacado.
mes | Sin embargo, se tardarían meses en machacarlos para convertir una fuerza así en un ejército.
elección | Una elección que quizá deberíamos agradecer.
tercero | —Inténtalo en la tercera compañía —sugirió Urfa.
mejor | —Los mejores asientos de la casa.
instar | —Prueba otra vez —instó alguien a Pizarra.
tapón | —¿El Tapón de Trapo, dice? Bueno, lo estaremos esperando.
jarro | Heuk levantó el jarro de barro y tomó un buen trago de su oscuro contenido.
charlar | Soldados, hombres y mujeres, iban y venían, riendo y charlando, muchos bebiendo de jarros de cuero.
encabezar | Los dos encabezaron la marcha de regreso, charlando en tono bajo y áspero.
diáspora | Qué había sido del hombre que había encabezado la primera compañía rumbo a la diáspora
balsa | En las balsas que la rodeaban, soldados talianos y aliados charlaban y reían.
contratar | Contratad todos los navíos azules que podáis.
compartir | Es solo que los talianos compartimos frontera con los setis.
loco | Noche llegó cuando se ponían en pie compartiendo sonrisas de loco—.
sobrevivir | Ese hombre estaba loco o solo resuelto a no sobrevivir al asedio
gélido | El agua gélida le dolió como si ardiera.
llegado | Atraparon a esos dos recién llegados.
saludo | —Saludos, recién llegados —dijo en taliano—.
odiar | La chamán los había odiado desde el principio.
atado | Kyle miró la espada que llevaba atada en la enorme vaina.
rasgar | Lleva las manos atadas a la espalda y tiene la ropa rasgada.
pantalón | Arrojo se inclinó hacia la herida y rasgó los pantalones para poder verla mejor.
invasor | Para él solo era otra raza más de invasores extranjeros.
considerar | En el continente muchos consideran a los malazanos invasores, igual que tú
poseer | No sabes acaso que Noche Ancestral, Kurald Galain, posee a sus hijos, los tiste andii
comentario | —A Kyle el comentario lo dejó perplejo, pero se inclinó de todos modos—.
estupendo | —¡Ah! ¡Estupendo! Todo el mundo se alegrará de oírlo.
garantizar | Permaneced con él y seguid sus órdenes y os garantizo que vuestras filas aguantarán.
impresionar | El vestido, la carreta y la escolta son solo para impresionar, nada más.
portar | Cuanto más se aproximaban los jinetes, tenía que admitir que más la impresionaba su porte.
gata | —No, yo solo era un sanador de Gato cuando nos invadieron los malazanos.
valer | Así que, como has visto, en realidad no valgo como mago de batalla.
vacilar | Se están invocando fuerzas que harían vacilar incluso a Ryllandaras.
tropezar | —No… —Aunque parecía flotar, fue como si Ammanas tropezara de repente y vaciló—.
antiguo | Tantos antiguos tenientes y compañeros.
guardaespaldas | Dos de los antiguos guardaespaldas de Dassem aquí, entre nosotros, ahora
poca | Pero recordaría su nombre, pocas veces había estado tan cerca de que lo vencieran.
nervio | —Pero ¿quieres dejarlo de una buena vez? Estás poniendo a todos de los nervios.
traidor | Tratar con traidores siempre lo ponía de los nervios.
duelo | Pero Cogulla se había enfrentado en duelo a Danzante en sus tiempos.
acento | —Bienvenidos a todos —dijo en taliano con un marcado acento—.
rodaballo | Uno de los soldados de su pelotón, Rodaballo (¿se llamaba así?) lo llamó y señaló aterrado al oeste.
advertencia | —¡El cabo Miedica, ese! —bramó Rodaballo levantando el dedo a modo de advertencia.
desconocer | La cara del desconocido le tapó el cielo.
medir | —Piense en ello como una medida de la importancia que tiene usted para nuestro comandante.
objeción | A medida que el tiempo pasaba, un muro de objeciones se fue alzando en su mente.
desierto | —Odio los desiertos —dijo Fochas.
historia | —Tú también viste las historias al subir, ¿eh? Buena elección.
fino | Una sonrisa levantó sus finos labios y lo invitó con un gesto a las llanuras vacías.
raer | Pantalones de tela raída y cuero fino desgarrado.
plagar | Madera rota y trozos raídos de tela plagaban la playa.
arcillar | Todo lo que habíamos soportado… —Frunció el ceño y estudió la pipa de arcilla blanca—.
construir | Sin embargo, tenía muchas otras funciones para los que lo construyeron.
hallar | Viajo al sur para hallar algún lugar en el que construir un barco.
complacer | Pese a que estaba claro que no se hallaba en absoluto complacido, Acecho asintió.
realizar | —Quizá todavía haya que realizar un pago…
planear | —No planeaba realizar ninguna marcha.
generación | Ella era la tercera generación oculta de la antigua familia Tayliin.
afirmar | Afirmaba que llevaba generaciones enteras en su familia.
rezar | Hace generaciones que mantenemos la esperanza y rezamos, y ahora ha regresado a nosotros.
sigilar | El tipo afirmó que el sigilo que portan es importante.
milímetro | Abajo había más gatos abriéndose paso milímetro a milímetro hasta las murallas.
desdeñoso | —Qué más da una dirección que otra —dijo Fochas con un ademán desdeñoso.
habitual | La sonrisa de Risueño recuperó su habitual gesto desdeñoso.
lista | Ante ellos, los hombres se agazapaban y se inclinaban tras las columnas con las ballestas listas.
bloquear | Listas para el bloqueo.
capturar | Capturado en un barco que intentaba romper el bloqueo.
bendecir | ¿Encontrarlo? Señora bendita, ¡van a ir a por él de verdad! Bueno, para eso vinieron.
jirón | Al acercarse vieron fuegos ardiendo entre las tiendas, muchas colgaban retorcidas y ladeadas, algunas hechas jirones.
silencioso | Sus cejas blancas se alzaron en silencioso comentario.
pronunciar | La mujer se quedó paralizada y pronunció una maldición silenciosa.
pendiente | Una pendiente de roca irregular y desnuda llevaba a la orilla silenciosa.
resbaladizo | Juntos cayeron rodando por la resbaladiza pendiente de barro y se precipitaron al agua.
invisible | Algo invisible hizo tropezar a Kyle, que cayó dando vueltas y deslizándose por la roca resbaladiza.
espectáculo | —Lo reconozco, los malazanos montáis mejores espectáculos de lo que nosotros lo hicimos jamás.
estremecimiento | Ghelel luchó por contener un estremecimiento, de miedo o asco, no lo sabía.
rey | El rey supremo se puso pálido y se apartó con un estremecimiento—.
actuar | —Huye ahora, rey supremo, o actuaré.
tranquilo | Resolvió actuar tan pronto como se presentara una noche tranquila.
reunión | Parecía ser el punto de reunión acordado.
burlar | —Esta no es una de vuestras reuniones del consejo, hombre de ciudad —se burló la niña—.
resplandeciente | Bala siguió abanicándose la cara resplandeciente y sudorosa mientras Ullen respondía a todos y cada uno.
cazar | Temían que la Guardia intentase darles caza
solicitar | —Solicito unirme a vuestra partida.
perra | ¡Eso es! Los Perros de la Pradera.
quienquiera | bendito fuera ese mago, quienquiera que fuese
reflexionar | Los Mellizos les sonrieron, quienesquiera que sean, reflexionó Hesalt.
situación | Reflexionaré sobre esa nueva luz que traes a la situación.
servicio | Quienquiera que fuera aquel hombre, había visto muchos años de duro servicio.
paciencia | Ghelel no estaba de humor para compartir la paciencia del marqués.
prometer | Os pido algo más de paciencia y os prometo una cosa, muchos más hombres se acercan.
fracasar | Si fracasas esta vez, no vivirás para prometer nada más.
capital | La caída de Laseen en Malaz capital, un fracaso.
control | La capital está ahora bajo el control de una troica de familias nobles talianas.
chusma | —Coge a tu chusma y levanta el campamento, y te prometo que no os perseguiremos.
demorar | estaba ese hombre demorándose mientras su chusma terminaba de rodearlos
cascar | —El casco gimió a su alrededor.
reacción | Su primera reacción fue volverse hacia V’thell, que asentía con el casco.
nordeste | Choss solicita que usted tome el flanco nordeste.
dominar | Toc estuvo a punto de echarse a reír, pero se dominó a tiempo.
trono | El trono le pareció entonces que se hallaba más cerca y que dominaba más superficie.
trampilla | El humo y el polvo salieron disparados por la trampilla abierta del tejado.
insistir | No iremos a atacar, ¿verdad? Es decir, ya tuvimos suerte una vez, no tiene sentido insistir.
vigilante | —El vigilante Durmis insistió en este intercambio de información.
ventaja | Podrían haberlos aplastado si hubieran aprovechado la ventaja que tenían.
mecer | Los dos habían perdido toda ventaja y se mecían como si carecieran de timón.
espuela | Kyle hubiera jurado que había sentido mecerse la Espuela.
huevo | El regular hizo un saludo militar y meció la cabeza calva de huevo.
vagar | Sintió una especie de irritación vaga, pero ya no estaba seguro de por qué.
sorprendente | Sus sorprendentes ojos dorados expresaban algo parecido al asombro cuando su mirada vagaba entre ellos.
horror | Había oído historias de horrores parecidos… Pero jamás habría creído…
incredulidad | Shell los miró, los ojos revelaban su absoluta incredulidad y horror.
confirmar | Un bufido confirmó la incredulidad del muchacho.
noticia | La mujer solo andaba a la caza de noticias de la emperatriz.
jefe | Nevall Od’Orr, factor jefe de Cawn
bandido | El jefe de los bandidos se dio una palmada en el muslo.
bando | Quedaban tan pocos en ambos bandos.
náufrago | —¿Crees que se rendirán? —se estremeció el náufrago, que tomaba grandes bocanadas de aire.
apropiar | —Con el debido respeto, un wickano sería más apropiado, conocería mejor el terreno…
asolar | Muchos decían que incluso habrían resistido contra los ejércitos de Kellanved, que habían asolado continentes enteros.
negociar | —Entonces tienes una cosa que aprender si quieres seguir con vida en este negocio.
disculpa | —Mis disculpas, preboste —dijo la voz del marqués—, pero han llegado noticias.
tablón | La tienda poseía un suelo de tablones.
levar | Ghelel empezaba a distinguir leves haces de luz que se colaban entre los tablones.
dañar | Hojalatero se acercó con las manos abiertas para demostrar que no pretendía hacer ningún daño.
investigación | —Es posible que el sujeto no sobreviva a la investigación.
rubio | Seda sacudía la cabeza y agitaba el fino cabello rubio.
valiente | Por Trake, esperaba que pudieran oírlo suficientes hombres y mujeres, tan valientes como locos, para seguirlo.
cabrón | Maldita sea, son unos cabrones muy valientes
pobre | —¡Mirad ahí! Un pobre cabrón al que guió hasta aquí para que se muriese.
asquear | Mareado y asqueado, Kyle se apoyó en un muro frío y resbaladizo.
volcar | Mientras Zarigüeya observaba, asqueado, el hombre volcó el jarro sobre su cabeza.
jadeo | El sobrino tragó saliva para calmar sus jadeos.
profundizar | Deberían continuar profundizando en esta investigación
farol | Con una mueca se protegió los ojos de la luz brillante del farol.
fulgor | El fulgor de fuegos y faroles iluminó la noche algo más adelante.
lengua | Un fulgor se abrió camino como una lengua entre las gruesas maderas de la trampilla.
palpar | El hombre se palpó la boca con la lengua y después se sacó un diente ensangrentado.
escalonar | Kyle palpó los escalones y sacó la mano seca como el polvo.
circular | El túnel se abría a una cámara circular tallada en la misma roca que los escalones.
amarillo | Al sur, el fulgor verde y amarillo de la magia de batalla era obvio.
sino | No, no eran estrellas, sino luces amarillas que parpadeaban, antorchas.
acariciar | El hombre acarició una saquita que le colgaba del cuello, una costumbre que tenía cuando pensaba.
herido | Los jinetes se arrojaron de sus monturas y corrieron hacia los heridos.
atestar | Yacía en una habitación atestada de muchos otros heridos.
mesa | —Se puso a gatas entre las atestadas mesas—.
secretar | —Eso es porque yo prefería que siguiera siendo un secreto.
escaso | Andamos escasos de magos, no es ningún secreto, así que os vais de caza.
pánico | Hesalt retrocedió, tenía un nudo en la garganta de puro pánico.
endurecer | Unos cuantos mercenarios continuaban en cubierta, los rostros endurecidos una vez pasado el pánico.
apostar | —Estoy dispuesto a apostar que esto no lo quemaron.
lección | Aquí hay una lección para cualquiera que se moleste en reflexionar sobre ella.
frecuencia | Aunque llegaban con mucha menos frecuencia, quizá ya habían aprendido la lección.
traicionar | No vio gestos en la joven que traicionaran que fuera consciente de su presencia.
templar | Se abrieron camino por los pasillos del templo de la ciudad.
estrangular | El hombre-chacal, la maldición de Quon, el hermano de Treach, estrangulado por un simple hombre
corazón | Pero tras un rato, el corazón en un frenesí, no pasó nada.
triunfar | Así que ella triunfó donde todos los demás habían fracasado.
cuestión | Solo era cuestión de adónde iban a apuntar.
azotar | Una espuma gélida azotó la cara de Ho.
ladera | El caos invadía las laderas en sombras cubiertas de hierba alta azotada por el viento.
divertido | Una vez más esa mirada divertida y astuta.
pulgar | Sonrió ante un pensamiento divertido repentino y se rascó la barbilla con el pulgar.
tripulación | La tripulación observó, divertida, al náufrago que se abría camino con esfuerzo hasta la popa.
cerner | El guardaespaldas se cernió sobre ellos.
hoguera | El oficial contempló lo que parecía una gran hoguera en ciernes.
rama | Las ramas del árbol se estaban moviendo.
ávido | La boca de Yath lucía una sonrisa de triunfo ávido.
espiral | Una masa de insectos se alzó de ella como una espiral y se dispersó.
montón | —Por los huesos del Embozado, solo son un montón de cartas.
trasto | Hay montones de balsas y trastos por allí.
desvanecer | La visión se apaga, el recuerdo se desvanece.
provincia | Quiero que la provincia de Unta vuelva a estar bajo nuestro control.
alistar | Y sigue creciendo, cada día que pasa se alistan más.
fiero | El anciano se limitaba a esbozar su fiera sonrisa de batalla, mostrando los dientes.
cansar | —Escúchalo —dijo Cotillion con tono cansado.
alternativo | —No tenemos alternativa —contestó K’azz con tono cansado.
resistencia | La alternativa… ¡Dioses! No era de extrañar que no hubiera habido resistencia, podías entrar cuando quisieras.
lealtad | Qué fácil conseguir su huida y garantizar su lealtad.
duquesa | Juramos lealtad eterna y servicio a nuestro duque mientras viviéramos y el Imperio permaneciera en pie.
recuerdo | Pero envía su lealtad continuada y recuerdos.
paliza | ¡Ah, estupendo! Les darían una paliza.
probablemente | Seguro que había crecido a base de palizas, de su padre, probablemente.
probable | Es probable que sigan librando su duelo.
bahía | En la bahía, las proas de los barcos habían girado hacia la orilla.
adivinar | Tenía la cara tan cerca (¡esos ojos!) que Kital adivinó el nombre y lo pronunció sin ruido.
necesidad | No vimos necesidad de despertaros.
atamán | Los atamanes hablaron todos a la vez para desechar cualquier necesidad de disculpa.
averiguar | ¿Cuántos podía haber? Toc y los atamanes tendrían los recursos para averiguarlo.
vital | De lo poco que tenemos hay una necesidad vital para alimentarnos nosotros y nuestros hijos.
formación | Los escaramuzadores de Laseen no estaban esperando a que sus unidades pesadas completaran la formación.
cerrado | —Formación cerrada aquí para forzar la retirada.
inspirar | Los guerreros que inspiraban semejante pavor no eran ningunos idiotas, como era obvio.
pegar | Tenía el largo cabello rubio pegado a la cabeza, empapado de sudor.
perímetro | —Menor, organiza un perímetro de hombres alrededor de la carreta.
silbido | El amanecer trajo un silbido y una llamada de los guardias del perímetro.
circunstancia | Pero, dadas las circunstancias, esa vez pensaba hacer las cosas a su manera.
extremar | —Digamos que primero dejé el servicio imperial en circunstancias extremas.
antebrazo | El demonio se sujetó el extremo del antebrazo.
largo | Acecho se incorporó y se sentó, después se envolvió las rodillas plegadas con los largos antebrazos.
musculoso | Le colgaban los brazos a los lados, largos, gruesos y musculosos.
tenue | La tenue tela cayó todavía más y reveló unos hombros pálidos y musculosos—.
colgadura | —Groten —llamó Bala a través de las tenues colgaduras blancas de tela—, permíteles acercarse.
internar | La joven apartó las colgaduras internas.
conversación | Tras un rato, Laseen asintió para sí como si hubiera puesto fin a una conversación interna.
sellar | —¿Recuerdas nuestra conversación de hace unos días? Partimos para sellar nuestro acuerdo con el trono.
cuerdo | —Cortó la cuerda que sellaba la bolsa—.
arsenal | Todo ello sellado con la marca del Arsenal Imperial.
robar | Dicen que en Unta debieron de intentar robar el Arsenal Imperial.
agujerar | El hombre la instó a atravesar aquel agujero dentado.
engañar | —No sé quién es esta pobre anciana engañada, caudillo.
acceder | Banath solo podía mirarla, confuso, pero accedió.
malicioso | Una pequeña sonrisa maliciosa tiró de los labios del duque.
debajo | Con una sonrisa maliciosa, Taya encogió las piernas debajo del cuerpo.
fresco | El sudor le corría por debajo del yelmo aunque el día era fresco.
directamente | Está formando otro portal, y esta vez lleva directamente a Quon.
desembarcar | A la mañana siguiente, en Desembarco de Canton, marcaron los árboles para el barco.
tartamudear | Tartamudeó algo (maldiciones probablemente) cuando bajaron su asiento a la cubierta.
consejero | —Es… —tartamudeó el consejero del puerto con la voz muy débil—, es…
arquero | Los talianos formaron filas de arqueros enfrente de la puerta mientras otros luchaban por cerrarla.
ballestero | Los que llevaban los escudos avanzaban cubriendo a sus arqueros o ballesteros.
aporrear | Los cascos aporreaban la línea de árboles, gritos para llamar a los ballesteros.
furia | Noche no respondió, seguía aporreando con furia la tierra seca.
humano | No es una hoja destinada a ningún humano, poco importa quién sea.
entidad | —Algunas entidades… —Mallick estiró la mano como si quisiera estrangular al anciano.
exir | —¡A Avore lo han borrado del mapa! Ya no existe tal entidad.
asentamiento | Suponía que llevaba demasiado tiempo alejado de cualquier asentamiento humano.
nudillo | Unos nudillos le golpearon el codo y un cuchillo largo salió volando de sus dedos entumecidos.
añicos | Añicos observó las llamas durante un rato, suspiró e hizo crujir los nudillos.
costra | Urko Costra, comandante de las fuerzas de Falar, de la vieja guardia, también conocido como Añicos
culto | Tú y tu culto perseguís vuestros propios intereses, no los míos.
local | Borraron del mapa a todos los demás cultos locales
reclutar | —¿Eres un recluta local? —preguntó el hombre.
incómodo | En las alturas, sobre ellos, los magistrados intercambiaron miradas incómodas.
ardiente | El puño del mago que lo sujetaba era incómodo y ardiente.
rayo | La rabia cruzó como un rayo ardiente la visión de Zarigüeya.
remediar | Vamos, teniente, desperdicie su vida si no le queda más remedio, pero piense en sus hombres.
próximo | —En el futuro próximo, en pocas palabras… sí.
permiso | —Le agradeceré que pida permiso para entrar la próxima vez.
detallar | —Los detalles habrá que negociarlos en un tratado, por supuesto.
lágrima | Kyle sintió las lágrimas calientes en las mejillas.
prestar | Las lágrimas les corrían por las mejillas sin que les prestaran ninguna atención.
arar | El Aro estaba demasiado concentrado en su ritual para prestarle atención alguna.
ralentizar | —¡Maestro del Aro! Ralentízalos.
acuchillar | Eso la ralentizó un poco más todavía y pude acuchillarle la cabeza unas cuantas veces.
romo | Cogió un puñado de ramas y las rompió con las manos, anchas y romas.
someter | Lo asaltó el ruido de un campamento atestado y sometido a un asedio.
tradición | Pero ahora, nuestra tradición ha vuelto a nosotros.
paso | El juramentado se había acercado unos seis pasos.
mínimo | En nuestra defensa, debo advertirle que costará mucho separarnos de lo mínimo.
pastor | Pastor hizo una mueca, como si se acabara de dar cuenta.
humana | Trell: pueblo nómada de pastores, no humanos
primo | Algunos podrían llamarlos mis primos, primos lejanos.
esfuerzo | Los tres primos se irguieron y abandonaron sus esfuerzos.